,ANO,UF,CARGO,PARTIDO,HOMENS,MULHERES,TOTAL,%MULHERES,%HOMENS
0,2010,AC,DEPUTADO ESTADUAL,PSDC,25,1,26,0.038461538461538464,0.9615384615384616
1,2010,AC,DEPUTADO ESTADUAL,PV,10,1,11,0.09090909090909091,0.9090909090909091
2,2010,AC,DEPUTADO ESTADUAL,PC do B,25,11,36,0.3055555555555556,0.6944444444444444
3,2010,AC,DEPUTADO ESTADUAL,PSB,28,8,36,0.2222222222222222,0.7777777777777778
4,2010,AC,DEPUTADO ESTADUAL,PSOL,10,2,12,0.16666666666666666,0.8333333333333334
5,2010,AC,DEPUTADO ESTADUAL,PTB,8,1,9,0.1111111111111111,0.8888888888888888
6,2010,AC,DEPUTADO ESTADUAL,PSDB,24,5,29,0.1724137931034483,0.8275862068965517
7,2010,AC,DEPUTADO ESTADUAL,PRTB,20,8,28,0.2857142857142857,0.7142857142857143
8,2010,AC,DEPUTADO ESTADUAL,PP,24,5,29,0.1724137931034483,0.8275862068965517
9,2010,AC,DEPUTADO ESTADUAL,PMN,15,6,21,0.2857142857142857,0.7142857142857143
10,2010,AC,DEPUTADO ESTADUAL,PT,19,4,23,0.17391304347826086,0.8260869565217391
11,2010,AC,DEPUTADO ESTADUAL,PTC,17,3,20,0.15,0.85
12,2010,AC,DEPUTADO ESTADUAL,PMDB,16,6,22,0.2727272727272727,0.7272727272727273
13,2010,AC,DEPUTADO ESTADUAL,DEM,11,3,14,0.21428571428571427,0.7857142857142857
14,2010,AC,DEPUTADO ESTADUAL,PTN,3,1,4,0.25,0.75
15,2010,AC,DEPUTADO ESTADUAL,PPS,14,4,18,0.2222222222222222,0.7777777777777778
16,2010,AC,DEPUTADO ESTADUAL,PRP,16,1,17,0.058823529411764705,0.9411764705882353
17,2010,AC,DEPUTADO ESTADUAL,PSC,8,3,11,0.2727272727272727,0.7272727272727273
18,2010,AC,DEPUTADO ESTADUAL,PRB,3,1,4,0.25,0.75
19,2010,AC,DEPUTADO ESTADUAL,PHS,2,0,2,0.0,1.0
20,2010,AC,DEPUTADO ESTADUAL,PT do B,2,1,3,0.3333333333333333,0.6666666666666666
21,2010,AC,DEPUTADO ESTADUAL,PR,3,2,5,0.4,0.6
22,2010,AC,DEPUTADO ESTADUAL,PSL,3,1,4,0.25,0.75
23,2010,AC,DEPUTADO ESTADUAL,PDT,4,0,4,0.0,1.0
24,2010,AC,DEPUTADO FEDERAL,PPS,3,1,4,0.25,0.75
25,2010,AC,DEPUTADO FEDERAL,PSC,3,2,5,0.4,0.6
26,2010,AC,DEPUTADO FEDERAL,PMDB,2,0,2,0.0,1.0
27,2010,AC,DEPUTADO FEDERAL,PR,2,0,2,0.0,1.0
28,2010,AC,DEPUTADO FEDERAL,PSDB,6,1,7,0.14285714285714285,0.8571428571428571
29,2010,AC,DEPUTADO FEDERAL,PTN,1,0,1,0.0,1.0
30,2010,AC,DEPUTADO FEDERAL,PT,5,1,6,0.16666666666666666,0.8333333333333334
31,2010,AC,DEPUTADO FEDERAL,PRP,2,0,2,0.0,1.0
32,2010,AC,DEPUTADO FEDERAL,PRTB,0,1,1,1.0,0.0
33,2010,AC,DEPUTADO FEDERAL,PSDC,1,0,1,0.0,1.0
34,2010,AC,DEPUTADO FEDERAL,PP,1,0,1,0.0,1.0
35,2010,AC,DEPUTADO FEDERAL,PTC,1,0,1,0.0,1.0
36,2010,AC,DEPUTADO FEDERAL,PV,2,0,2,0.0,1.0
37,2010,AC,DEPUTADO FEDERAL,PDT,1,0,1,0.0,1.0
38,2010,AC,DEPUTADO FEDERAL,PSB,1,0,1,0.0,1.0
39,2010,AC,DEPUTADO FEDERAL,DEM,2,0,2,0.0,1.0
40,2010,AC,DEPUTADO FEDERAL,PC do B,0,1,1,1.0,0.0
41,2010,AC,DEPUTADO FEDERAL,PTB,0,1,1,1.0,0.0
42,2010,AC,DEPUTADO FEDERAL,PSOL,1,0,1,0.0,1.0
43,2010,AC,DEPUTADO FEDERAL,PMN,0,2,2,1.0,0.0
44,2010,AC,DEPUTADO FEDERAL,PRB,1,0,1,0.0,1.0
45,2010,AC,SENADOR,PSOL,1,0,1,0.0,1.0
46,2010,AC,SENADOR,PC do B,1,0,1,0.0,1.0
47,2010,AC,SENADOR,PMDB,1,0,1,0.0,1.0
48,2010,AC,SENADOR,PT,1,0,1,0.0,1.0
49,2010,AC,SENADOR,PMN,1,0,1,0.0,1.0
50,2014,AC,DEPUTADO ESTADUAL,PRP,26,10,36,0.2777777777777778,0.7222222222222222
51,2014,AC,DEPUTADO ESTADUAL,PTB,3,0,3,0.0,1.0
52,2014,AC,DEPUTADO ESTADUAL,PC do B,8,5,13,0.38461538461538464,0.6153846153846154
53,2014,AC,DEPUTADO ESTADUAL,PSOL,7,3,10,0.3,0.7
54,2014,AC,DEPUTADO ESTADUAL,PV,18,8,26,0.3076923076923077,0.6923076923076923
55,2014,AC,DEPUTADO ESTADUAL,PT,18,10,28,0.35714285714285715,0.6428571428571429
56,2014,AC,DEPUTADO ESTADUAL,PEN,5,1,6,0.16666666666666666,0.8333333333333334
57,2014,AC,DEPUTADO ESTADUAL,PRB,16,4,20,0.2,0.8
58,2014,AC,DEPUTADO ESTADUAL,PSD,18,8,26,0.3076923076923077,0.6923076923076923
59,2014,AC,DEPUTADO ESTADUAL,PDT,25,11,36,0.3055555555555556,0.6944444444444444
60,2014,AC,DEPUTADO ESTADUAL,PTC,2,2,4,0.5,0.5
61,2014,AC,DEPUTADO ESTADUAL,PMN,4,2,6,0.3333333333333333,0.6666666666666666
62,2014,AC,DEPUTADO ESTADUAL,DEM,20,10,30,0.3333333333333333,0.6666666666666666
63,2014,AC,DEPUTADO ESTADUAL,PSB,22,10,32,0.3125,0.6875
64,2014,AC,DEPUTADO ESTADUAL,PPS,16,7,23,0.30434782608695654,0.6956521739130435
65,2014,AC,DEPUTADO ESTADUAL,PSDC,22,10,32,0.3125,0.6875
66,2014,AC,DEPUTADO ESTADUAL,PR,17,8,25,0.32,0.68
67,2014,AC,DEPUTADO ESTADUAL,PSC,11,4,15,0.26666666666666666,0.7333333333333333
68,2014,AC,DEPUTADO ESTADUAL,PSDB,20,6,26,0.23076923076923078,0.7692307692307693
69,2014,AC,DEPUTADO ESTADUAL,PTN,14,8,22,0.36363636363636365,0.6363636363636364
70,2014,AC,DEPUTADO ESTADUAL,PHS,7,6,13,0.46153846153846156,0.5384615384615384
71,2014,AC,DEPUTADO ESTADUAL,PP,28,13,41,0.3170731707317073,0.6829268292682927
72,2014,AC,DEPUTADO ESTADUAL,PPL,11,3,14,0.21428571428571427,0.7857142857142857
73,2014,AC,DEPUTADO ESTADUAL,PMDB,12,4,16,0.25,0.75
74,2014,AC,DEPUTADO ESTADUAL,PT do B,5,5,10,0.5,0.5
75,2014,AC,DEPUTADO ESTADUAL,PROS,1,1,2,0.5,0.5
76,2014,AC,DEPUTADO ESTADUAL,SD,7,3,10,0.3,0.7
77,2014,AC,DEPUTADO ESTADUAL,PSL,4,1,5,0.2,0.8
78,2014,AC,DEPUTADO FEDERAL,PSDB,4,1,5,0.2,0.8
79,2014,AC,DEPUTADO FEDERAL,DEM,6,2,8,0.25,0.75
80,2014,AC,DEPUTADO FEDERAL,PT do B,1,1,2,0.5,0.5
81,2014,AC,DEPUTADO FEDERAL,PMDB,2,1,3,0.3333333333333333,0.6666666666666666
82,2014,AC,DEPUTADO FEDERAL,PP,5,2,7,0.2857142857142857,0.7142857142857143
83,2014,AC,DEPUTADO FEDERAL,SD,1,0,1,0.0,1.0
84,2014,AC,DEPUTADO FEDERAL,PMN,0,1,1,1.0,0.0
85,2014,AC,DEPUTADO FEDERAL,PSOL,2,1,3,0.3333333333333333,0.6666666666666666
86,2014,AC,DEPUTADO FEDERAL,PV,2,2,4,0.5,0.5
87,2014,AC,DEPUTADO FEDERAL,PSD,2,2,4,0.5,0.5
88,2014,AC,DEPUTADO FEDERAL,PT,5,6,11,0.5454545454545454,0.45454545454545453
89,2014,AC,DEPUTADO FEDERAL,PSL,0,1,1,1.0,0.0
90,2014,AC,DEPUTADO FEDERAL,PPS,1,0,1,0.0,1.0
91,2014,AC,DEPUTADO FEDERAL,PSC,0,1,1,1.0,0.0
92,2014,AC,DEPUTADO FEDERAL,PRB,1,0,1,0.0,1.0
93,2014,AC,DEPUTADO FEDERAL,PRP,1,0,1,0.0,1.0
94,2014,AC,DEPUTADO FEDERAL,PR,1,0,1,0.0,1.0
95,2014,AC,DEPUTADO FEDERAL,PDT,1,0,1,0.0,1.0
96,2014,AC,DEPUTADO FEDERAL,PSB,1,0,1,0.0,1.0
97,2014,AC,DEPUTADO FEDERAL,PHS,1,0,1,0.0,1.0
98,2014,AC,DEPUTADO FEDERAL,PTB,0,1,1,1.0,0.0
99,2014,AC,DEPUTADO FEDERAL,PC do B,1,0,1,0.0,1.0
100,2014,AC,DEPUTADO FEDERAL,PROS,1,0,1,0.0,1.0
101,2014,AC,DEPUTADO FEDERAL,PPL,2,0,2,0.0,1.0
102,2014,AC,DEPUTADO FEDERAL,PTN,1,0,1,0.0,1.0
103,2014,AC,DEPUTADO FEDERAL,PSDC,1,0,1,0.0,1.0
104,2014,AC,SENADOR,PP,1,0,1,0.0,1.0
105,2014,AC,SENADOR,PSOL,1,0,1,0.0,1.0
106,2014,AC,SENADOR,PC do B,0,1,1,1.0,0.0
107,2014,AC,SENADOR,PMN,1,0,1,0.0,1.0
108,2018,AC,DEPUTADO ESTADUAL,PDT,19,9,28,0.32142857142857145,0.6785714285714286
109,2018,AC,DEPUTADO ESTADUAL,PRP,15,4,19,0.21052631578947367,0.7894736842105263
110,2018,AC,DEPUTADO ESTADUAL,DEM,11,5,16,0.3125,0.6875
111,2018,AC,DEPUTADO ESTADUAL,PRB,9,6,15,0.4,0.6
112,2018,AC,DEPUTADO ESTADUAL,PSDB,22,10,32,0.3125,0.6875
113,2018,AC,DEPUTADO ESTADUAL,PSL,22,8,30,0.26666666666666666,0.7333333333333333
114,2018,AC,DEPUTADO ESTADUAL,PP,18,10,28,0.35714285714285715,0.6428571428571429
115,2018,AC,DEPUTADO ESTADUAL,PPS,10,2,12,0.16666666666666666,0.8333333333333334
116,2018,AC,DEPUTADO ESTADUAL,PTB,19,9,28,0.32142857142857145,0.6785714285714286
117,2018,AC,DEPUTADO ESTADUAL,PMB,5,3,8,0.375,0.625
118,2018,AC,DEPUTADO ESTADUAL,PATRI,1,2,3,0.6666666666666666,0.3333333333333333
119,2018,AC,DEPUTADO ESTADUAL,MDB,10,7,17,0.4117647058823529,0.5882352941176471
120,2018,AC,DEPUTADO ESTADUAL,PT,13,7,20,0.35,0.65
121,2018,AC,DEPUTADO ESTADUAL,PSB,23,12,35,0.34285714285714286,0.6571428571428571
122,2018,AC,DEPUTADO ESTADUAL,PSC,7,4,11,0.36363636363636365,0.6363636363636364
123,2018,AC,DEPUTADO ESTADUAL,PSD,8,3,11,0.2727272727272727,0.7272727272727273
124,2018,AC,DEPUTADO ESTADUAL,PHS,16,6,22,0.2727272727272727,0.7272727272727273
125,2018,AC,DEPUTADO ESTADUAL,DC,17,9,26,0.34615384615384615,0.6538461538461539
126,2018,AC,DEPUTADO ESTADUAL,REDE,7,3,10,0.3,0.7
127,2018,AC,DEPUTADO ESTADUAL,PSOL,6,5,11,0.45454545454545453,0.5454545454545454
128,2018,AC,DEPUTADO ESTADUAL,PODE,11,2,13,0.15384615384615385,0.8461538461538461
129,2018,AC,DEPUTADO ESTADUAL,PC do B,3,2,5,0.4,0.6
130,2018,AC,DEPUTADO ESTADUAL,SOLIDARIEDADE,15,9,24,0.375,0.625
131,2018,AC,DEPUTADO ESTADUAL,PRTB,11,3,14,0.21428571428571427,0.7857142857142857
132,2018,AC,DEPUTADO ESTADUAL,PROS,5,3,8,0.375,0.625
133,2018,AC,DEPUTADO ESTADUAL,PV,6,4,10,0.4,0.6
134,2018,AC,DEPUTADO ESTADUAL,PTC,2,2,4,0.5,0.5
135,2018,AC,DEPUTADO ESTADUAL,PMN,2,2,4,0.5,0.5
136,2018,AC,DEPUTADO ESTADUAL,PR,3,0,3,0.0,1.0
137,2018,AC,DEPUTADO ESTADUAL,PPL,2,0,2,0.0,1.0
138,2018,AC,DEPUTADO FEDERAL,PSL,5,3,8,0.375,0.625
139,2018,AC,DEPUTADO FEDERAL,PDT,11,6,17,0.35294117647058826,0.6470588235294118
140,2018,AC,DEPUTADO FEDERAL,DC,2,1,3,0.3333333333333333,0.6666666666666666
141,2018,AC,DEPUTADO FEDERAL,PSDB,0,1,1,1.0,0.0
142,2018,AC,DEPUTADO FEDERAL,PROS,2,0,2,0.0,1.0
143,2018,AC,DEPUTADO FEDERAL,PRP,2,1,3,0.3333333333333333,0.6666666666666666
144,2018,AC,DEPUTADO FEDERAL,PPS,0,1,1,1.0,0.0
145,2018,AC,DEPUTADO FEDERAL,PP,3,0,3,0.0,1.0
146,2018,AC,DEPUTADO FEDERAL,AVANTE,6,3,9,0.3333333333333333,0.6666666666666666
147,2018,AC,DEPUTADO FEDERAL,PT,3,2,5,0.4,0.6
148,2018,AC,DEPUTADO FEDERAL,PC do B,0,1,1,1.0,0.0
149,2018,AC,DEPUTADO FEDERAL,MDB,3,1,4,0.25,0.75
150,2018,AC,DEPUTADO FEDERAL,PSOL,3,1,4,0.25,0.75
151,2018,AC,DEPUTADO FEDERAL,PTB,0,1,1,1.0,0.0
152,2018,AC,DEPUTADO FEDERAL,PV,1,1,2,0.5,0.5
153,2018,AC,DEPUTADO FEDERAL,PPL,1,0,1,0.0,1.0
154,2018,AC,DEPUTADO FEDERAL,PSB,1,0,1,0.0,1.0
155,2018,AC,DEPUTADO FEDERAL,PATRI,1,0,1,0.0,1.0
156,2018,AC,DEPUTADO FEDERAL,PODE,1,1,2,0.5,0.5
157,2018,AC,DEPUTADO FEDERAL,PHS,2,0,2,0.0,1.0
158,2018,AC,DEPUTADO FEDERAL,REDE,1,1,2,0.5,0.5
159,2018,AC,DEPUTADO FEDERAL,DEM,1,0,1,0.0,1.0
160,2018,AC,DEPUTADO FEDERAL,PRB,1,0,1,0.0,1.0
161,2018,AC,DEPUTADO FEDERAL,SOLIDARIEDADE,0,1,1,1.0,0.0
162,2018,AC,DEPUTADO FEDERAL,PSD,1,0,1,0.0,1.0
163,2018,AC,DEPUTADO FEDERAL,PRTB,1,1,2,0.5,0.5
164,2018,AC,DEPUTADO FEDERAL,PMB,0,1,1,1.0,0.0
165,2018,AC,DEPUTADO FEDERAL,PR,0,1,1,1.0,0.0
166,2018,AC,DEPUTADO FEDERAL,PTC,1,0,1,0.0,1.0
167,2018,AC,DEPUTADO FEDERAL,PMN,1,0,1,0.0,1.0
168,2018,AC,DEPUTADO FEDERAL,PSC,1,0,1,0.0,1.0
169,2018,AC,SENADOR,PT,2,0,2,0.0,1.0
170,2018,AC,SENADOR,PSD,1,0,1,0.0,1.0
171,2018,AC,SENADOR,REDE,1,0,1,0.0,1.0
172,2018,AC,SENADOR,PSL,1,0,1,0.0,1.0
173,2018,AC,SENADOR,MDB,1,0,1,0.0,1.0
174,2010,AL,DEPUTADO ESTADUAL,PRTB,18,2,20,0.1,0.9
175,2010,AL,DEPUTADO ESTADUAL,PDT,15,5,20,0.25,0.75
176,2010,AL,DEPUTADO ESTADUAL,PPS,25,11,36,0.3055555555555556,0.6944444444444444
177,2010,AL,DEPUTADO ESTADUAL,PSB,4,4,8,0.5,0.5
178,2010,AL,DEPUTADO ESTADUAL,PMDB,13,1,14,0.07142857142857142,0.9285714285714286
179,2010,AL,DEPUTADO ESTADUAL,PV,15,4,19,0.21052631578947367,0.7894736842105263
180,2010,AL,DEPUTADO ESTADUAL,PMN,12,2,14,0.14285714285714285,0.8571428571428571
181,2010,AL,DEPUTADO ESTADUAL,PSL,14,0,14,0.0,1.0
182,2010,AL,DEPUTADO ESTADUAL,PSC,1,2,3,0.6666666666666666,0.3333333333333333
183,2010,AL,DEPUTADO ESTADUAL,PTB,15,2,17,0.11764705882352941,0.8823529411764706
184,2010,AL,DEPUTADO ESTADUAL,PC do B,3,2,5,0.4,0.6
185,2010,AL,DEPUTADO ESTADUAL,PSDB,18,2,20,0.1,0.9
186,2010,AL,DEPUTADO ESTADUAL,PT do B,4,2,6,0.3333333333333333,0.6666666666666666
187,2010,AL,DEPUTADO ESTADUAL,DEM,18,4,22,0.18181818181818182,0.8181818181818182
188,2010,AL,DEPUTADO ESTADUAL,PSOL,28,12,40,0.3,0.7
189,2010,AL,DEPUTADO ESTADUAL,PP,5,3,8,0.375,0.625
190,2010,AL,DEPUTADO ESTADUAL,PRB,4,0,4,0.0,1.0
191,2010,AL,DEPUTADO ESTADUAL,PTN,15,5,20,0.25,0.75
192,2010,AL,DEPUTADO ESTADUAL,PCB,2,1,3,0.3333333333333333,0.6666666666666666
193,2010,AL,DEPUTADO ESTADUAL,PT,16,7,23,0.30434782608695654,0.6956521739130435
194,2010,AL,DEPUTADO ESTADUAL,PSDC,1,0,1,0.0,1.0
195,2010,AL,DEPUTADO ESTADUAL,PR,9,0,9,0.0,1.0
196,2010,AL,DEPUTADO ESTADUAL,PRP,2,0,2,0.0,1.0
197,2010,AL,DEPUTADO ESTADUAL,PTC,1,0,1,0.0,1.0
198,2010,AL,DEPUTADO ESTADUAL,PHS,2,0,2,0.0,1.0
199,2010,AL,DEPUTADO FEDERAL,PTB,4,3,7,0.42857142857142855,0.5714285714285714
200,2010,AL,DEPUTADO FEDERAL,PRP,2,0,2,0.0,1.0
201,2010,AL,DEPUTADO FEDERAL,PSDB,5,1,6,0.16666666666666666,0.8333333333333334
202,2010,AL,DEPUTADO FEDERAL,PSOL,9,4,13,0.3076923076923077,0.6923076923076923
203,2010,AL,DEPUTADO FEDERAL,PSB,4,0,4,0.0,1.0
204,2010,AL,DEPUTADO FEDERAL,PP,2,1,3,0.3333333333333333,0.6666666666666666
205,2010,AL,DEPUTADO FEDERAL,PC do B,1,1,2,0.5,0.5
206,2010,AL,DEPUTADO FEDERAL,PSC,2,0,2,0.0,1.0
207,2010,AL,DEPUTADO FEDERAL,PTN,1,1,2,0.5,0.5
208,2010,AL,DEPUTADO FEDERAL,PMN,4,1,5,0.2,0.8
209,2010,AL,DEPUTADO FEDERAL,PSDC,2,1,3,0.3333333333333333,0.6666666666666666
210,2010,AL,DEPUTADO FEDERAL,PHS,4,0,4,0.0,1.0
211,2010,AL,DEPUTADO FEDERAL,PR,2,0,2,0.0,1.0
212,2010,AL,DEPUTADO FEDERAL,DEM,3,1,4,0.25,0.75
213,2010,AL,DEPUTADO FEDERAL,PT,4,0,4,0.0,1.0
214,2010,AL,DEPUTADO FEDERAL,PMDB,4,1,5,0.2,0.8
215,2010,AL,DEPUTADO FEDERAL,PT do B,1,2,3,0.6666666666666666,0.3333333333333333
216,2010,AL,DEPUTADO FEDERAL,PV,1,0,1,0.0,1.0
217,2010,AL,DEPUTADO FEDERAL,PSL,2,0,2,0.0,1.0
218,2010,AL,DEPUTADO FEDERAL,PRB,3,1,4,0.25,0.75
219,2010,AL,DEPUTADO FEDERAL,PDT,1,0,1,0.0,1.0
220,2010,AL,DEPUTADO FEDERAL,PCB,1,0,1,0.0,1.0
221,2010,AL,DEPUTADO FEDERAL,PRTB,2,0,2,0.0,1.0
222,2010,AL,DEPUTADO FEDERAL,PPS,0,1,1,1.0,0.0
223,2010,AL,SENADOR,PTB,2,0,2,0.0,1.0
224,2010,AL,SENADOR,PP,1,0,1,0.0,1.0
225,2010,AL,SENADOR,PCB,1,0,1,0.0,1.0
226,2010,AL,SENADOR,PC do B,1,0,1,0.0,1.0
227,2010,AL,SENADOR,PSOL,0,1,1,1.0,0.0
228,2010,AL,SENADOR,PRTB,2,0,2,0.0,1.0
229,2010,AL,SENADOR,PPS,1,0,1,0.0,1.0
230,2010,AL,SENADOR,PMDB,1,0,1,0.0,1.0
231,2014,AL,DEPUTADO ESTADUAL,PSOL,7,3,10,0.3,0.7
232,2014,AL,DEPUTADO ESTADUAL,PPS,13,8,21,0.38095238095238093,0.6190476190476191
233,2014,AL,DEPUTADO ESTADUAL,PSD,4,2,6,0.3333333333333333,0.6666666666666666
234,2014,AL,DEPUTADO ESTADUAL,PT,18,8,26,0.3076923076923077,0.6923076923076923
235,2014,AL,DEPUTADO ESTADUAL,PTB,13,4,17,0.23529411764705882,0.7647058823529411
236,2014,AL,DEPUTADO ESTADUAL,PHS,12,7,19,0.3684210526315789,0.631578947368421
237,2014,AL,DEPUTADO ESTADUAL,PTC,9,4,13,0.3076923076923077,0.6923076923076923
238,2014,AL,DEPUTADO ESTADUAL,PMDB,17,6,23,0.2608695652173913,0.7391304347826086
239,2014,AL,DEPUTADO ESTADUAL,PT do B,6,3,9,0.3333333333333333,0.6666666666666666
240,2014,AL,DEPUTADO ESTADUAL,PP,6,8,14,0.5714285714285714,0.42857142857142855
241,2014,AL,DEPUTADO ESTADUAL,DEM,5,1,6,0.16666666666666666,0.8333333333333334
242,2014,AL,DEPUTADO ESTADUAL,SD,7,2,9,0.2222222222222222,0.7777777777777778
243,2014,AL,DEPUTADO ESTADUAL,PDT,11,6,17,0.35294117647058826,0.6470588235294118
244,2014,AL,DEPUTADO ESTADUAL,PROS,7,2,9,0.2222222222222222,0.7777777777777778
245,2014,AL,DEPUTADO ESTADUAL,PRTB,18,10,28,0.35714285714285715,0.6428571428571429
246,2014,AL,DEPUTADO ESTADUAL,PRB,9,4,13,0.3076923076923077,0.6923076923076923
247,2014,AL,DEPUTADO ESTADUAL,PSB,14,2,16,0.125,0.875
248,2014,AL,DEPUTADO ESTADUAL,PSDB,14,8,22,0.36363636363636365,0.6363636363636364
249,2014,AL,DEPUTADO ESTADUAL,PPL,6,2,8,0.25,0.75
250,2014,AL,DEPUTADO ESTADUAL,PR,2,0,2,0.0,1.0
251,2014,AL,DEPUTADO ESTADUAL,PMN,3,2,5,0.4,0.6
252,2014,AL,DEPUTADO ESTADUAL,PV,5,2,7,0.2857142857142857,0.7142857142857143
253,2014,AL,DEPUTADO ESTADUAL,PSC,0,2,2,1.0,0.0
254,2014,AL,DEPUTADO ESTADUAL,PSDC,2,0,2,0.0,1.0
255,2014,AL,DEPUTADO ESTADUAL,PSTU,0,1,1,1.0,0.0
256,2014,AL,DEPUTADO ESTADUAL,PC do B,1,1,2,0.5,0.5
257,2014,AL,DEPUTADO FEDERAL,PPS,3,3,6,0.5,0.5
258,2014,AL,DEPUTADO FEDERAL,PMDB,9,4,13,0.3076923076923077,0.6923076923076923
259,2014,AL,DEPUTADO FEDERAL,PCB,1,0,1,0.0,1.0
260,2014,AL,DEPUTADO FEDERAL,PSOL,3,2,5,0.4,0.6
261,2014,AL,DEPUTADO FEDERAL,PSDB,9,5,14,0.35714285714285715,0.6428571428571429
262,2014,AL,DEPUTADO FEDERAL,PTC,3,2,5,0.4,0.6
263,2014,AL,DEPUTADO FEDERAL,PP,5,4,9,0.4444444444444444,0.5555555555555556
264,2014,AL,DEPUTADO FEDERAL,PRTB,14,5,19,0.2631578947368421,0.7368421052631579
265,2014,AL,DEPUTADO FEDERAL,PMN,2,2,4,0.5,0.5
266,2014,AL,DEPUTADO FEDERAL,PRB,7,4,11,0.36363636363636365,0.6363636363636364
267,2014,AL,DEPUTADO FEDERAL,SD,2,0,2,0.0,1.0
268,2014,AL,DEPUTADO FEDERAL,PSDC,2,0,2,0.0,1.0
269,2014,AL,DEPUTADO FEDERAL,DEM,4,0,4,0.0,1.0
270,2014,AL,DEPUTADO FEDERAL,PSC,1,0,1,0.0,1.0
271,2014,AL,DEPUTADO FEDERAL,PSD,2,0,2,0.0,1.0
272,2014,AL,DEPUTADO FEDERAL,PROS,1,0,1,0.0,1.0
273,2014,AL,DEPUTADO FEDERAL,PTB,2,0,2,0.0,1.0
274,2014,AL,DEPUTADO FEDERAL,PT do B,0,2,2,1.0,0.0
275,2014,AL,DEPUTADO FEDERAL,PDT,1,1,2,0.5,0.5
276,2014,AL,DEPUTADO FEDERAL,PEN,1,1,2,0.5,0.5
277,2014,AL,DEPUTADO FEDERAL,PSB,2,2,4,0.5,0.5
278,2014,AL,DEPUTADO FEDERAL,PSTU,1,0,1,0.0,1.0
279,2014,AL,DEPUTADO FEDERAL,PPL,1,0,1,0.0,1.0
280,2014,AL,DEPUTADO FEDERAL,PR,1,1,2,0.5,0.5
281,2014,AL,DEPUTADO FEDERAL,PV,1,2,3,0.6666666666666666,0.3333333333333333
282,2014,AL,DEPUTADO FEDERAL,PHS,1,0,1,0.0,1.0
283,2014,AL,DEPUTADO FEDERAL,PTN,1,0,1,0.0,1.0
284,2014,AL,DEPUTADO FEDERAL,PRP,1,0,1,0.0,1.0
285,2014,AL,DEPUTADO FEDERAL,PT,1,0,1,0.0,1.0
286,2014,AL,SENADOR,PTN,1,0,1,0.0,1.0
287,2014,AL,SENADOR,PTC,1,0,1,0.0,1.0
288,2014,AL,SENADOR,PTB,1,0,1,0.0,1.0
289,2014,AL,SENADOR,PSOL,0,1,1,1.0,0.0
290,2014,AL,SENADOR,PSDB,1,0,1,0.0,1.0
291,2014,AL,SENADOR,DEM,1,0,1,0.0,1.0
292,2014,AL,SENADOR,PEN,1,0,1,0.0,1.0
293,2014,AL,SENADOR,PRTB,1,0,1,0.0,1.0
294,2018,AL,DEPUTADO ESTADUAL,PATRI,13,2,15,0.13333333333333333,0.8666666666666667
295,2018,AL,DEPUTADO ESTADUAL,AVANTE,18,9,27,0.3333333333333333,0.6666666666666666
296,2018,AL,DEPUTADO ESTADUAL,PSDB,2,4,6,0.6666666666666666,0.3333333333333333
297,2018,AL,DEPUTADO ESTADUAL,PT,23,9,32,0.28125,0.71875
298,2018,AL,DEPUTADO ESTADUAL,PP,6,2,8,0.25,0.75
299,2018,AL,DEPUTADO ESTADUAL,PSTU,1,0,1,0.0,1.0
300,2018,AL,DEPUTADO ESTADUAL,PSL,14,8,22,0.36363636363636365,0.6363636363636364
301,2018,AL,DEPUTADO ESTADUAL,PPS,10,5,15,0.3333333333333333,0.6666666666666666
302,2018,AL,DEPUTADO ESTADUAL,MDB,12,9,21,0.42857142857142855,0.5714285714285714
303,2018,AL,DEPUTADO ESTADUAL,DEM,5,2,7,0.2857142857142857,0.7142857142857143
304,2018,AL,DEPUTADO ESTADUAL,PROS,6,1,7,0.14285714285714285,0.8571428571428571
305,2018,AL,DEPUTADO ESTADUAL,PV,8,5,13,0.38461538461538464,0.6153846153846154
306,2018,AL,DEPUTADO ESTADUAL,PDT,9,3,12,0.25,0.75
307,2018,AL,DEPUTADO ESTADUAL,REDE,2,2,4,0.5,0.5
308,2018,AL,DEPUTADO ESTADUAL,PC do B,6,2,8,0.25,0.75
309,2018,AL,DEPUTADO ESTADUAL,PRTB,18,9,27,0.3333333333333333,0.6666666666666666
310,2018,AL,DEPUTADO ESTADUAL,PRB,2,0,2,0.0,1.0
311,2018,AL,DEPUTADO ESTADUAL,PPL,8,6,14,0.42857142857142855,0.5714285714285714
312,2018,AL,DEPUTADO ESTADUAL,PHS,7,3,10,0.3,0.7
313,2018,AL,DEPUTADO ESTADUAL,SOLIDARIEDADE,3,0,3,0.0,1.0
314,2018,AL,DEPUTADO ESTADUAL,PSD,5,1,6,0.16666666666666666,0.8333333333333334
315,2018,AL,DEPUTADO ESTADUAL,PSOL,24,11,35,0.3142857142857143,0.6857142857142857
316,2018,AL,DEPUTADO ESTADUAL,PTC,4,5,9,0.5555555555555556,0.4444444444444444
317,2018,AL,DEPUTADO ESTADUAL,DC,2,0,2,0.0,1.0
318,2018,AL,DEPUTADO ESTADUAL,PODE,3,1,4,0.25,0.75
319,2018,AL,DEPUTADO ESTADUAL,PSC,1,1,2,0.5,0.5
320,2018,AL,DEPUTADO ESTADUAL,PTB,2,1,3,0.3333333333333333,0.6666666666666666
321,2018,AL,DEPUTADO ESTADUAL,PSB,7,2,9,0.2222222222222222,0.7777777777777778
322,2018,AL,DEPUTADO ESTADUAL,PCB,0,1,1,1.0,0.0
323,2018,AL,DEPUTADO ESTADUAL,PMN,4,2,6,0.3333333333333333,0.6666666666666666
324,2018,AL,DEPUTADO ESTADUAL,PR,1,0,1,0.0,1.0
325,2018,AL,DEPUTADO FEDERAL,AVANTE,1,0,1,0.0,1.0
326,2018,AL,DEPUTADO FEDERAL,NOVO,2,1,3,0.3333333333333333,0.6666666666666666
327,2018,AL,DEPUTADO FEDERAL,MDB,1,2,3,0.6666666666666666,0.3333333333333333
328,2018,AL,DEPUTADO FEDERAL,PC do B,3,1,4,0.25,0.75
329,2018,AL,DEPUTADO FEDERAL,PP,3,2,5,0.4,0.6
330,2018,AL,DEPUTADO FEDERAL,PSL,8,3,11,0.2727272727272727,0.7272727272727273
331,2018,AL,DEPUTADO FEDERAL,PRB,1,0,1,0.0,1.0
332,2018,AL,DEPUTADO FEDERAL,PSC,1,1,2,0.5,0.5
333,2018,AL,DEPUTADO FEDERAL,PODE,1,0,1,0.0,1.0
334,2018,AL,DEPUTADO FEDERAL,PATRI,3,1,4,0.25,0.75
335,2018,AL,DEPUTADO FEDERAL,SOLIDARIEDADE,1,1,2,0.5,0.5
336,2018,AL,DEPUTADO FEDERAL,PHS,5,2,7,0.2857142857142857,0.7142857142857143
337,2018,AL,DEPUTADO FEDERAL,PSOL,1,1,2,0.5,0.5
338,2018,AL,DEPUTADO FEDERAL,PR,1,0,1,0.0,1.0
339,2018,AL,DEPUTADO FEDERAL,PSDB,2,1,3,0.3333333333333333,0.6666666666666666
340,2018,AL,DEPUTADO FEDERAL,PTC,2,0,2,0.0,1.0
341,2018,AL,DEPUTADO FEDERAL,PSD,1,1,2,0.5,0.5
342,2018,AL,DEPUTADO FEDERAL,PPL,2,2,4,0.5,0.5
343,2018,AL,DEPUTADO FEDERAL,PTB,1,1,2,0.5,0.5
344,2018,AL,DEPUTADO FEDERAL,PSTU,1,0,1,0.0,1.0
345,2018,AL,DEPUTADO FEDERAL,PSB,2,0,2,0.0,1.0
346,2018,AL,DEPUTADO FEDERAL,DEM,0,2,2,1.0,0.0
347,2018,AL,DEPUTADO FEDERAL,PDT,2,0,2,0.0,1.0
348,2018,AL,DEPUTADO FEDERAL,PMN,0,1,1,1.0,0.0
349,2018,AL,DEPUTADO FEDERAL,PV,1,1,2,0.5,0.5
350,2018,AL,DEPUTADO FEDERAL,PRTB,3,1,4,0.25,0.75
351,2018,AL,DEPUTADO FEDERAL,PPS,1,0,1,0.0,1.0
352,2018,AL,DEPUTADO FEDERAL,PROS,1,0,1,0.0,1.0
353,2018,AL,DEPUTADO FEDERAL,PT,1,0,1,0.0,1.0
354,2018,AL,DEPUTADO FEDERAL,PCO,0,1,1,1.0,0.0
355,2018,AL,DEPUTADO FEDERAL,DC,1,1,2,0.5,0.5
356,2018,AL,DEPUTADO FEDERAL,REDE,0,1,1,1.0,0.0
357,2018,AL,DEPUTADO FEDERAL,PCB,1,0,1,0.0,1.0
358,2018,AL,SENADOR,PP,1,0,1,0.0,1.0
359,2018,AL,SENADOR,MDB,1,0,1,0.0,1.0
360,2018,AL,SENADOR,PCB,1,0,1,0.0,1.0
361,2018,AL,SENADOR,PSDB,1,0,1,0.0,1.0
362,2018,AL,SENADOR,PR,1,0,1,0.0,1.0
363,2018,AL,SENADOR,PCO,0,1,1,1.0,0.0
364,2018,AL,SENADOR,PSL,1,0,1,0.0,1.0
365,2018,AL,SENADOR,PATRI,1,0,1,0.0,1.0
366,2018,AL,SENADOR,PSOL,1,0,1,0.0,1.0
367,2010,AP,DEPUTADO ESTADUAL,PTB,42,14,56,0.25,0.75
368,2010,AP,DEPUTADO ESTADUAL,PRTB,18,7,25,0.28,0.72
369,2010,AP,DEPUTADO ESTADUAL,PT do B,8,1,9,0.1111111111111111,0.8888888888888888
370,2010,AP,DEPUTADO ESTADUAL,PSB,11,13,24,0.5416666666666666,0.4583333333333333
371,2010,AP,DEPUTADO ESTADUAL,PSDB,11,8,19,0.42105263157894735,0.5789473684210527
372,2010,AP,DEPUTADO ESTADUAL,PP,19,5,24,0.20833333333333334,0.7916666666666666
373,2010,AP,DEPUTADO ESTADUAL,PSTU,1,1,2,0.5,0.5
374,2010,AP,DEPUTADO ESTADUAL,PT,14,1,15,0.06666666666666667,0.9333333333333333
375,2010,AP,DEPUTADO ESTADUAL,PDT,14,6,20,0.3,0.7
376,2010,AP,DEPUTADO ESTADUAL,PTN,6,2,8,0.25,0.75
377,2010,AP,DEPUTADO ESTADUAL,PSC,12,5,17,0.29411764705882354,0.7058823529411765
378,2010,AP,DEPUTADO ESTADUAL,PRP,12,4,16,0.25,0.75
379,2010,AP,DEPUTADO ESTADUAL,DEM,16,4,20,0.2,0.8
380,2010,AP,DEPUTADO ESTADUAL,PHS,1,1,2,0.5,0.5
381,2010,AP,DEPUTADO ESTADUAL,PMDB,7,1,8,0.125,0.875
382,2010,AP,DEPUTADO ESTADUAL,PPS,5,1,6,0.16666666666666666,0.8333333333333334
383,2010,AP,DEPUTADO ESTADUAL,PRB,4,1,5,0.2,0.8
384,2010,AP,DEPUTADO ESTADUAL,PV,8,1,9,0.1111111111111111,0.8888888888888888
385,2010,AP,DEPUTADO ESTADUAL,PMN,8,0,8,0.0,1.0
386,2010,AP,DEPUTADO ESTADUAL,PSOL,9,6,15,0.4,0.6
387,2010,AP,DEPUTADO ESTADUAL,PR,5,2,7,0.2857142857142857,0.7142857142857143
388,2010,AP,DEPUTADO ESTADUAL,PCB,2,8,10,0.8,0.2
389,2010,AP,DEPUTADO ESTADUAL,PC do B,6,0,6,0.0,1.0
390,2010,AP,DEPUTADO ESTADUAL,PSDC,6,0,6,0.0,1.0
391,2010,AP,DEPUTADO ESTADUAL,PSL,1,0,1,0.0,1.0
392,2010,AP,DEPUTADO FEDERAL,PPS,1,1,2,0.5,0.5
393,2010,AP,DEPUTADO FEDERAL,PDT,5,2,7,0.2857142857142857,0.7142857142857143
394,2010,AP,DEPUTADO FEDERAL,PSC,4,1,5,0.2,0.8
395,2010,AP,DEPUTADO FEDERAL,PRTB,4,0,4,0.0,1.0
396,2010,AP,DEPUTADO FEDERAL,PTB,18,4,22,0.18181818181818182,0.8181818181818182
397,2010,AP,DEPUTADO FEDERAL,PSB,5,2,7,0.2857142857142857,0.7142857142857143
398,2010,AP,DEPUTADO FEDERAL,PTC,2,4,6,0.6666666666666666,0.3333333333333333
399,2010,AP,DEPUTADO FEDERAL,PV,1,1,2,0.5,0.5
400,2010,AP,DEPUTADO FEDERAL,PSOL,2,0,2,0.0,1.0
401,2010,AP,DEPUTADO FEDERAL,DEM,4,1,5,0.2,0.8
402,2010,AP,DEPUTADO FEDERAL,PRB,1,0,1,0.0,1.0
403,2010,AP,DEPUTADO FEDERAL,PHS,1,0,1,0.0,1.0
404,2010,AP,DEPUTADO FEDERAL,PTN,1,0,1,0.0,1.0
405,2010,AP,DEPUTADO FEDERAL,PT,2,2,4,0.5,0.5
406,2010,AP,DEPUTADO FEDERAL,PP,4,1,5,0.2,0.8
407,2010,AP,DEPUTADO FEDERAL,PC do B,1,0,1,0.0,1.0
408,2010,AP,DEPUTADO FEDERAL,PMDB,2,1,3,0.3333333333333333,0.6666666666666666
409,2010,AP,DEPUTADO FEDERAL,PSDB,4,1,5,0.2,0.8
410,2010,AP,DEPUTADO FEDERAL,PRP,2,6,8,0.75,0.25
411,2010,AP,DEPUTADO FEDERAL,PMN,6,0,6,0.0,1.0
412,2010,AP,DEPUTADO FEDERAL,PSTU,1,0,1,0.0,1.0
413,2010,AP,DEPUTADO FEDERAL,PR,0,2,2,1.0,0.0
414,2010,AP,DEPUTADO FEDERAL,PCB,2,0,2,0.0,1.0
415,2010,AP,SENADOR,PDT,1,0,1,0.0,1.0
416,2010,AP,SENADOR,PC do B,1,0,1,0.0,1.0
417,2010,AP,SENADOR,PSTU,1,0,1,0.0,1.0
418,2010,AP,SENADOR,PMDB,1,0,1,0.0,1.0
419,2010,AP,SENADOR,PSB,1,0,1,0.0,1.0
420,2010,AP,SENADOR,PSDB,1,0,1,0.0,1.0
421,2010,AP,SENADOR,PT,1,0,1,0.0,1.0
422,2010,AP,SENADOR,PSOL,2,0,2,0.0,1.0
423,2014,AP,DEPUTADO ESTADUAL,PSD,13,5,18,0.2777777777777778,0.7222222222222222
424,2014,AP,DEPUTADO ESTADUAL,PV,8,3,11,0.2727272727272727,0.7272727272727273
425,2014,AP,DEPUTADO ESTADUAL,PROS,5,4,9,0.4444444444444444,0.5555555555555556
426,2014,AP,DEPUTADO ESTADUAL,PSC,25,11,36,0.3055555555555556,0.6944444444444444
427,2014,AP,DEPUTADO ESTADUAL,PRP,14,6,20,0.3,0.7
428,2014,AP,DEPUTADO ESTADUAL,PP,4,2,6,0.3333333333333333,0.6666666666666666
429,2014,AP,DEPUTADO ESTADUAL,PTN,11,4,15,0.26666666666666666,0.7333333333333333
430,2014,AP,DEPUTADO ESTADUAL,DEM,6,3,9,0.3333333333333333,0.6666666666666666
431,2014,AP,DEPUTADO ESTADUAL,PT do B,16,8,24,0.3333333333333333,0.6666666666666666
432,2014,AP,DEPUTADO ESTADUAL,PSDC,7,2,9,0.2222222222222222,0.7777777777777778
433,2014,AP,DEPUTADO ESTADUAL,PC do B,5,2,7,0.2857142857142857,0.7142857142857143
434,2014,AP,DEPUTADO ESTADUAL,PRB,16,4,20,0.2,0.8
435,2014,AP,DEPUTADO ESTADUAL,PDT,8,7,15,0.4666666666666667,0.5333333333333333
436,2014,AP,DEPUTADO ESTADUAL,PMDB,8,0,8,0.0,1.0
437,2014,AP,DEPUTADO ESTADUAL,PPL,3,4,7,0.5714285714285714,0.42857142857142855
438,2014,AP,DEPUTADO ESTADUAL,PMN,2,1,3,0.3333333333333333,0.6666666666666666
439,2014,AP,DEPUTADO ESTADUAL,PT,9,4,13,0.3076923076923077,0.6923076923076923
440,2014,AP,DEPUTADO ESTADUAL,PRTB,12,4,16,0.25,0.75
441,2014,AP,DEPUTADO ESTADUAL,PSOL,20,10,30,0.3333333333333333,0.6666666666666666
442,2014,AP,DEPUTADO ESTADUAL,PSB,14,6,20,0.3,0.7
443,2014,AP,DEPUTADO ESTADUAL,PPS,10,5,15,0.3333333333333333,0.6666666666666666
444,2014,AP,DEPUTADO ESTADUAL,PR,16,9,25,0.36,0.64
445,2014,AP,DEPUTADO ESTADUAL,PEN,7,3,10,0.3,0.7
446,2014,AP,DEPUTADO ESTADUAL,PHS,5,3,8,0.375,0.625
447,2014,AP,DEPUTADO ESTADUAL,PTC,5,0,5,0.0,1.0
448,2014,AP,DEPUTADO ESTADUAL,PTB,4,1,5,0.2,0.8
449,2014,AP,DEPUTADO ESTADUAL,PSTU,1,1,2,0.5,0.5
450,2014,AP,DEPUTADO ESTADUAL,PSDB,8,4,12,0.3333333333333333,0.6666666666666666
451,2014,AP,DEPUTADO ESTADUAL,SD,4,1,5,0.2,0.8
452,2014,AP,DEPUTADO FEDERAL,PRTB,4,0,4,0.0,1.0
453,2014,AP,DEPUTADO FEDERAL,PSB,1,1,2,0.5,0.5
454,2014,AP,DEPUTADO FEDERAL,PROS,4,0,4,0.0,1.0
455,2014,AP,DEPUTADO FEDERAL,PV,2,1,3,0.3333333333333333,0.6666666666666666
456,2014,AP,DEPUTADO FEDERAL,PMDB,3,2,5,0.4,0.6
457,2014,AP,DEPUTADO FEDERAL,PPS,2,0,2,0.0,1.0
458,2014,AP,DEPUTADO FEDERAL,PMN,1,1,2,0.5,0.5
459,2014,AP,DEPUTADO FEDERAL,PSOL,9,3,12,0.25,0.75
460,2014,AP,DEPUTADO FEDERAL,PSTU,1,1,2,0.5,0.5
461,2014,AP,DEPUTADO FEDERAL,PSDB,4,2,6,0.3333333333333333,0.6666666666666666
462,2014,AP,DEPUTADO FEDERAL,PC do B,2,2,4,0.5,0.5
463,2014,AP,DEPUTADO FEDERAL,PEN,2,2,4,0.5,0.5
464,2014,AP,DEPUTADO FEDERAL,PRP,1,0,1,0.0,1.0
465,2014,AP,DEPUTADO FEDERAL,PT do B,2,0,2,0.0,1.0
466,2014,AP,DEPUTADO FEDERAL,PSDC,3,4,7,0.5714285714285714,0.42857142857142855
467,2014,AP,DEPUTADO FEDERAL,PSC,4,4,8,0.5,0.5
468,2014,AP,DEPUTADO FEDERAL,PTB,1,2,3,0.6666666666666666,0.3333333333333333
469,2014,AP,DEPUTADO FEDERAL,PT,3,2,5,0.4,0.6
470,2014,AP,DEPUTADO FEDERAL,PDT,5,5,10,0.5,0.5
471,2014,AP,DEPUTADO FEDERAL,PRB,1,0,1,0.0,1.0
472,2014,AP,DEPUTADO FEDERAL,PSD,5,3,8,0.375,0.625
473,2014,AP,DEPUTADO FEDERAL,PP,2,2,4,0.5,0.5
474,2014,AP,DEPUTADO FEDERAL,SD,3,1,4,0.25,0.75
475,2014,AP,DEPUTADO FEDERAL,PR,2,0,2,0.0,1.0
476,2014,AP,DEPUTADO FEDERAL,PPL,2,1,3,0.3333333333333333,0.6666666666666666
477,2014,AP,DEPUTADO FEDERAL,DEM,4,1,5,0.2,0.8
478,2014,AP,DEPUTADO FEDERAL,PHS,0,1,1,1.0,0.0
479,2014,AP,DEPUTADO FEDERAL,PTC,1,0,1,0.0,1.0
480,2014,AP,SENADOR,PTC,0,1,1,1.0,0.0
481,2014,AP,SENADOR,PRTB,1,0,1,0.0,1.0
482,2014,AP,SENADOR,PMDB,1,0,1,0.0,1.0
483,2014,AP,SENADOR,PEN,1,0,1,0.0,1.0
484,2014,AP,SENADOR,PCB,1,0,1,0.0,1.0
485,2014,AP,SENADOR,PT,0,1,1,1.0,0.0
486,2014,AP,SENADOR,PMN,0,1,1,1.0,0.0
487,2014,AP,SENADOR,DEM,1,0,1,0.0,1.0
488,2014,AP,SENADOR,PSTU,1,0,1,0.0,1.0
489,2014,AP,SENADOR,PRP,1,0,1,0.0,1.0
490,2018,AP,DEPUTADO ESTADUAL,DEM,11,7,18,0.3888888888888889,0.6111111111111112
491,2018,AP,DEPUTADO ESTADUAL,MDB,5,2,7,0.2857142857142857,0.7142857142857143
492,2018,AP,DEPUTADO ESTADUAL,DC,3,1,4,0.25,0.75
493,2018,AP,DEPUTADO ESTADUAL,PDT,8,8,16,0.5,0.5
494,2018,AP,DEPUTADO ESTADUAL,PC do B,6,2,8,0.25,0.75
495,2018,AP,DEPUTADO ESTADUAL,PSB,22,10,32,0.3125,0.6875
496,2018,AP,DEPUTADO ESTADUAL,PRB,5,4,9,0.4444444444444444,0.5555555555555556
497,2018,AP,DEPUTADO ESTADUAL,SOLIDARIEDADE,5,4,9,0.4444444444444444,0.5555555555555556
498,2018,AP,DEPUTADO ESTADUAL,PT,13,8,21,0.38095238095238093,0.6190476190476191
499,2018,AP,DEPUTADO ESTADUAL,PSOL,9,3,12,0.25,0.75
500,2018,AP,DEPUTADO ESTADUAL,REDE,19,9,28,0.32142857142857145,0.6785714285714286
501,2018,AP,DEPUTADO ESTADUAL,PPS,8,5,13,0.38461538461538464,0.6153846153846154
502,2018,AP,DEPUTADO ESTADUAL,PP,18,9,27,0.3333333333333333,0.6666666666666666
503,2018,AP,DEPUTADO ESTADUAL,PODE,18,10,28,0.35714285714285715,0.6428571428571429
504,2018,AP,DEPUTADO ESTADUAL,PPL,5,2,7,0.2857142857142857,0.7142857142857143
505,2018,AP,DEPUTADO ESTADUAL,PR,27,10,37,0.2702702702702703,0.7297297297297297
506,2018,AP,DEPUTADO ESTADUAL,PTC,26,12,38,0.3157894736842105,0.6842105263157895
507,2018,AP,DEPUTADO ESTADUAL,PSL,6,1,7,0.14285714285714285,0.8571428571428571
508,2018,AP,DEPUTADO ESTADUAL,PSC,23,11,34,0.3235294117647059,0.6764705882352942
509,2018,AP,DEPUTADO ESTADUAL,PV,17,7,24,0.2916666666666667,0.7083333333333334
510,2018,AP,DEPUTADO ESTADUAL,PSDB,10,6,16,0.375,0.625
511,2018,AP,DEPUTADO ESTADUAL,PSD,6,4,10,0.4,0.6
512,2018,AP,DEPUTADO ESTADUAL,PMN,2,2,4,0.5,0.5
513,2018,AP,DEPUTADO ESTADUAL,PHS,7,6,13,0.46153846153846156,0.5384615384615384
514,2018,AP,DEPUTADO ESTADUAL,PRP,15,8,23,0.34782608695652173,0.6521739130434783
515,2018,AP,DEPUTADO ESTADUAL,AVANTE,5,1,6,0.16666666666666666,0.8333333333333334
516,2018,AP,DEPUTADO ESTADUAL,PROS,11,5,16,0.3125,0.6875
517,2018,AP,DEPUTADO ESTADUAL,PMB,6,5,11,0.45454545454545453,0.5454545454545454
518,2018,AP,DEPUTADO ESTADUAL,PTB,5,2,7,0.2857142857142857,0.7142857142857143
519,2018,AP,DEPUTADO ESTADUAL,PATRI,6,0,6,0.0,1.0
520,2018,AP,DEPUTADO ESTADUAL,PSTU,1,1,2,0.5,0.5
521,2018,AP,DEPUTADO FEDERAL,MDB,3,2,5,0.4,0.6
522,2018,AP,DEPUTADO FEDERAL,PSL,1,0,1,0.0,1.0
523,2018,AP,DEPUTADO FEDERAL,PR,6,2,8,0.25,0.75
524,2018,AP,DEPUTADO FEDERAL,SOLIDARIEDADE,2,1,3,0.3333333333333333,0.6666666666666666
525,2018,AP,DEPUTADO FEDERAL,PDT,6,2,8,0.25,0.75
526,2018,AP,DEPUTADO FEDERAL,PHS,3,4,7,0.5714285714285714,0.42857142857142855
527,2018,AP,DEPUTADO FEDERAL,PTC,4,1,5,0.2,0.8
528,2018,AP,DEPUTADO FEDERAL,PSOL,4,3,7,0.42857142857142855,0.5714285714285714
529,2018,AP,DEPUTADO FEDERAL,PT,3,5,8,0.625,0.375
530,2018,AP,DEPUTADO FEDERAL,PSB,8,3,11,0.2727272727272727,0.7272727272727273
531,2018,AP,DEPUTADO FEDERAL,PSDB,1,1,2,0.5,0.5
532,2018,AP,DEPUTADO FEDERAL,AVANTE,1,1,2,0.5,0.5
533,2018,AP,DEPUTADO FEDERAL,REDE,6,1,7,0.14285714285714285,0.8571428571428571
534,2018,AP,DEPUTADO FEDERAL,DEM,4,1,5,0.2,0.8
535,2018,AP,DEPUTADO FEDERAL,PROS,2,0,2,0.0,1.0
536,2018,AP,DEPUTADO FEDERAL,PRB,0,1,1,1.0,0.0
537,2018,AP,DEPUTADO FEDERAL,PV,5,1,6,0.16666666666666666,0.8333333333333334
538,2018,AP,DEPUTADO FEDERAL,PSC,2,1,3,0.3333333333333333,0.6666666666666666
539,2018,AP,DEPUTADO FEDERAL,PTB,6,1,7,0.14285714285714285,0.8571428571428571
540,2018,AP,DEPUTADO FEDERAL,PPL,2,1,3,0.3333333333333333,0.6666666666666666
541,2018,AP,DEPUTADO FEDERAL,PMN,3,1,4,0.25,0.75
542,2018,AP,DEPUTADO FEDERAL,PP,1,1,2,0.5,0.5
543,2018,AP,DEPUTADO FEDERAL,PSD,2,1,3,0.3333333333333333,0.6666666666666666
544,2018,AP,DEPUTADO FEDERAL,PATRI,1,0,1,0.0,1.0
545,2018,AP,DEPUTADO FEDERAL,PSTU,1,1,2,0.5,0.5
546,2018,AP,DEPUTADO FEDERAL,PPS,1,0,1,0.0,1.0
547,2018,AP,DEPUTADO FEDERAL,DC,0,1,1,1.0,0.0
548,2018,AP,DEPUTADO FEDERAL,PRP,1,1,2,0.5,0.5
549,2018,AP,DEPUTADO FEDERAL,PC do B,0,1,1,1.0,0.0
550,2018,AP,DEPUTADO FEDERAL,PODE,0,1,1,1.0,0.0
551,2018,AP,SENADOR,PMN,1,0,1,0.0,1.0
552,2018,AP,SENADOR,MDB,1,1,2,0.5,0.5
553,2018,AP,SENADOR,PTC,1,0,1,0.0,1.0
554,2018,AP,SENADOR,REDE,1,0,1,0.0,1.0
555,2018,AP,SENADOR,PSB,0,1,1,1.0,0.0
556,2018,AP,SENADOR,PCB,0,1,1,1.0,0.0
557,2018,AP,SENADOR,PSDB,1,0,1,0.0,1.0
558,2018,AP,SENADOR,PSL,1,0,1,0.0,1.0
559,2018,AP,SENADOR,PPS,1,0,1,0.0,1.0
560,2018,AP,SENADOR,PSTU,1,0,1,0.0,1.0
561,2018,AP,SENADOR,PTB,1,0,1,0.0,1.0
562,2010,AM,DEPUTADO ESTADUAL,PTN,36,15,51,0.29411764705882354,0.7058823529411765
563,2010,AM,DEPUTADO ESTADUAL,PDT,17,6,23,0.2608695652173913,0.7391304347826086
564,2010,AM,DEPUTADO ESTADUAL,PPS,13,4,17,0.23529411764705882,0.7647058823529411
565,2010,AM,DEPUTADO ESTADUAL,DEM,20,8,28,0.2857142857142857,0.7142857142857143
566,2010,AM,DEPUTADO ESTADUAL,PR,15,7,22,0.3181818181818182,0.6818181818181818
567,2010,AM,DEPUTADO ESTADUAL,PSDB,14,6,20,0.3,0.7
568,2010,AM,DEPUTADO ESTADUAL,PT,16,8,24,0.3333333333333333,0.6666666666666666
569,2010,AM,DEPUTADO ESTADUAL,PV,19,10,29,0.3448275862068966,0.6551724137931034
570,2010,AM,DEPUTADO ESTADUAL,PRP,19,4,23,0.17391304347826086,0.8260869565217391
571,2010,AM,DEPUTADO ESTADUAL,PMN,16,2,18,0.1111111111111111,0.8888888888888888
572,2010,AM,DEPUTADO ESTADUAL,PP,8,4,12,0.3333333333333333,0.6666666666666666
573,2010,AM,DEPUTADO ESTADUAL,PSB,8,4,12,0.3333333333333333,0.6666666666666666
574,2010,AM,DEPUTADO ESTADUAL,PC do B,28,12,40,0.3,0.7
575,2010,AM,DEPUTADO ESTADUAL,PMDB,12,12,24,0.5,0.5
576,2010,AM,DEPUTADO ESTADUAL,PT do B,3,1,4,0.25,0.75
577,2010,AM,DEPUTADO ESTADUAL,PSDC,4,3,7,0.42857142857142855,0.5714285714285714
578,2010,AM,DEPUTADO ESTADUAL,PRB,4,4,8,0.5,0.5
579,2010,AM,DEPUTADO ESTADUAL,PSL,13,5,18,0.2777777777777778,0.7222222222222222
580,2010,AM,DEPUTADO ESTADUAL,PSOL,4,0,4,0.0,1.0
581,2010,AM,DEPUTADO ESTADUAL,PTC,3,2,5,0.4,0.6
582,2010,AM,DEPUTADO ESTADUAL,PTB,8,8,16,0.5,0.5
583,2010,AM,DEPUTADO ESTADUAL,PRTB,3,0,3,0.0,1.0
584,2010,AM,DEPUTADO ESTADUAL,PHS,4,0,4,0.0,1.0
585,2010,AM,DEPUTADO ESTADUAL,PSC,4,0,4,0.0,1.0
586,2010,AM,DEPUTADO ESTADUAL,PSTU,0,1,1,1.0,0.0
587,2010,AM,DEPUTADO ESTADUAL,PCB,1,0,1,0.0,1.0
588,2010,AM,DEPUTADO FEDERAL,PSB,2,1,3,0.3333333333333333,0.6666666666666666
589,2010,AM,DEPUTADO FEDERAL,PT,1,1,2,0.5,0.5
590,2010,AM,DEPUTADO FEDERAL,PMDB,3,7,10,0.7,0.3
591,2010,AM,DEPUTADO FEDERAL,PT do B,3,2,5,0.4,0.6
592,2010,AM,DEPUTADO FEDERAL,PTB,3,0,3,0.0,1.0
593,2010,AM,DEPUTADO FEDERAL,PMN,3,0,3,0.0,1.0
594,2010,AM,DEPUTADO FEDERAL,PCB,1,0,1,0.0,1.0
595,2010,AM,DEPUTADO FEDERAL,PP,1,1,2,0.5,0.5
596,2010,AM,DEPUTADO FEDERAL,PSC,2,0,2,0.0,1.0
597,2010,AM,DEPUTADO FEDERAL,PR,3,0,3,0.0,1.0
598,2010,AM,DEPUTADO FEDERAL,DEM,2,1,3,0.3333333333333333,0.6666666666666666
599,2010,AM,DEPUTADO FEDERAL,PSDB,3,2,5,0.4,0.6
600,2010,AM,DEPUTADO FEDERAL,PRP,1,0,1,0.0,1.0
601,2010,AM,DEPUTADO FEDERAL,PHS,3,1,4,0.25,0.75
602,2010,AM,DEPUTADO FEDERAL,PV,5,3,8,0.375,0.625
603,2010,AM,DEPUTADO FEDERAL,PC do B,1,0,1,0.0,1.0
604,2010,AM,DEPUTADO FEDERAL,PSTU,1,0,1,0.0,1.0
605,2010,AM,DEPUTADO FEDERAL,PSOL,2,0,2,0.0,1.0
606,2010,AM,DEPUTADO FEDERAL,PRTB,1,0,1,0.0,1.0
607,2010,AM,DEPUTADO FEDERAL,PPS,2,1,3,0.3333333333333333,0.6666666666666666
608,2010,AM,DEPUTADO FEDERAL,PSL,3,1,4,0.25,0.75
609,2010,AM,DEPUTADO FEDERAL,PSDC,1,0,1,0.0,1.0
610,2010,AM,DEPUTADO FEDERAL,PDT,1,1,2,0.5,0.5
611,2010,AM,DEPUTADO FEDERAL,PRB,1,0,1,0.0,1.0
612,2010,AM,SENADOR,PSDB,1,0,1,0.0,1.0
613,2010,AM,SENADOR,PMDB,1,0,1,0.0,1.0
614,2010,AM,SENADOR,PSOL,2,0,2,0.0,1.0
615,2010,AM,SENADOR,PRB,1,0,1,0.0,1.0
616,2010,AM,SENADOR,PCB,1,0,1,0.0,1.0
617,2010,AM,SENADOR,PDT,1,0,1,0.0,1.0
618,2010,AM,SENADOR,PT,0,1,1,1.0,0.0
619,2010,AM,SENADOR,PSTU,1,0,1,0.0,1.0
620,2010,AM,SENADOR,PC do B,0,1,1,1.0,0.0
621,2014,AM,DEPUTADO ESTADUAL,DEM,22,15,37,0.40540540540540543,0.5945945945945946
622,2014,AM,DEPUTADO ESTADUAL,PSC,5,0,5,0.0,1.0
623,2014,AM,DEPUTADO ESTADUAL,PT do B,10,4,14,0.2857142857142857,0.7142857142857143
624,2014,AM,DEPUTADO ESTADUAL,PSD,8,2,10,0.2,0.8
625,2014,AM,DEPUTADO ESTADUAL,PROS,11,8,19,0.42105263157894735,0.5789473684210527
626,2014,AM,DEPUTADO ESTADUAL,PSDB,21,10,31,0.3225806451612903,0.6774193548387096
627,2014,AM,DEPUTADO ESTADUAL,PC do B,30,14,44,0.3181818181818182,0.6818181818181818
628,2014,AM,DEPUTADO ESTADUAL,PTC,15,3,18,0.16666666666666666,0.8333333333333334
629,2014,AM,DEPUTADO ESTADUAL,PTN,34,19,53,0.3584905660377358,0.6415094339622641
630,2014,AM,DEPUTADO ESTADUAL,PP,13,3,16,0.1875,0.8125
631,2014,AM,DEPUTADO ESTADUAL,PMDB,15,10,25,0.4,0.6
632,2014,AM,DEPUTADO ESTADUAL,PRB,5,4,9,0.4444444444444444,0.5555555555555556
633,2014,AM,DEPUTADO ESTADUAL,PT,10,3,13,0.23076923076923078,0.7692307692307693
634,2014,AM,DEPUTADO ESTADUAL,PPS,20,12,32,0.375,0.625
635,2014,AM,DEPUTADO ESTADUAL,PHS,16,6,22,0.2727272727272727,0.7272727272727273
636,2014,AM,DEPUTADO ESTADUAL,PV,32,18,50,0.36,0.64
637,2014,AM,DEPUTADO ESTADUAL,PSB,30,14,44,0.3181818181818182,0.6818181818181818
638,2014,AM,DEPUTADO ESTADUAL,PSDC,29,8,37,0.21621621621621623,0.7837837837837838
639,2014,AM,DEPUTADO ESTADUAL,PPL,8,9,17,0.5294117647058824,0.47058823529411764
640,2014,AM,DEPUTADO ESTADUAL,SD,3,2,5,0.4,0.6
641,2014,AM,DEPUTADO ESTADUAL,PR,10,5,15,0.3333333333333333,0.6666666666666666
642,2014,AM,DEPUTADO ESTADUAL,PCB,2,1,3,0.3333333333333333,0.6666666666666666
643,2014,AM,DEPUTADO ESTADUAL,PSOL,17,8,25,0.32,0.68
644,2014,AM,DEPUTADO ESTADUAL,PTB,9,2,11,0.18181818181818182,0.8181818181818182
645,2014,AM,DEPUTADO ESTADUAL,PDT,15,5,20,0.25,0.75
646,2014,AM,DEPUTADO ESTADUAL,PSL,12,3,15,0.2,0.8
647,2014,AM,DEPUTADO ESTADUAL,PSTU,2,1,3,0.3333333333333333,0.6666666666666666
648,2014,AM,DEPUTADO ESTADUAL,PMN,12,6,18,0.3333333333333333,0.6666666666666666
649,2014,AM,DEPUTADO ESTADUAL,PRP,12,5,17,0.29411764705882354,0.7058823529411765
650,2014,AM,DEPUTADO ESTADUAL,PEN,7,0,7,0.0,1.0
651,2014,AM,DEPUTADO ESTADUAL,PRTB,2,0,2,0.0,1.0
652,2014,AM,DEPUTADO FEDERAL,PHS,2,1,3,0.3333333333333333,0.6666666666666666
653,2014,AM,DEPUTADO FEDERAL,PV,1,1,2,0.5,0.5
654,2014,AM,DEPUTADO FEDERAL,PT,4,3,7,0.42857142857142855,0.5714285714285714
655,2014,AM,DEPUTADO FEDERAL,PMDB,3,1,4,0.25,0.75
656,2014,AM,DEPUTADO FEDERAL,PDT,4,0,4,0.0,1.0
657,2014,AM,DEPUTADO FEDERAL,PSB,3,2,5,0.4,0.6
658,2014,AM,DEPUTADO FEDERAL,PRP,10,4,14,0.2857142857142857,0.7142857142857143
659,2014,AM,DEPUTADO FEDERAL,PSD,4,1,5,0.2,0.8
660,2014,AM,DEPUTADO FEDERAL,PMN,2,1,3,0.3333333333333333,0.6666666666666666
661,2014,AM,DEPUTADO FEDERAL,PTN,1,1,2,0.5,0.5
662,2014,AM,DEPUTADO FEDERAL,DEM,1,0,1,0.0,1.0
663,2014,AM,DEPUTADO FEDERAL,PROS,1,1,2,0.5,0.5
664,2014,AM,DEPUTADO FEDERAL,PSOL,5,3,8,0.375,0.625
665,2014,AM,DEPUTADO FEDERAL,PT do B,0,1,1,1.0,0.0
666,2014,AM,DEPUTADO FEDERAL,PSC,0,1,1,1.0,0.0
667,2014,AM,DEPUTADO FEDERAL,PRB,1,3,4,0.75,0.25
668,2014,AM,DEPUTADO FEDERAL,PPS,1,0,1,0.0,1.0
669,2014,AM,DEPUTADO FEDERAL,PCB,1,1,2,0.5,0.5
670,2014,AM,DEPUTADO FEDERAL,PR,1,1,2,0.5,0.5
671,2014,AM,DEPUTADO FEDERAL,PTC,2,0,2,0.0,1.0
672,2014,AM,DEPUTADO FEDERAL,PTB,1,0,1,0.0,1.0
673,2014,AM,DEPUTADO FEDERAL,SD,0,1,1,1.0,0.0
674,2014,AM,DEPUTADO FEDERAL,PSL,1,0,1,0.0,1.0
675,2014,AM,DEPUTADO FEDERAL,PP,0,1,1,1.0,0.0
676,2014,AM,DEPUTADO FEDERAL,PSDB,1,0,1,0.0,1.0
677,2014,AM,DEPUTADO FEDERAL,PC do B,1,0,1,0.0,1.0
678,2014,AM,DEPUTADO FEDERAL,PSTU,1,1,2,0.5,0.5
679,2014,AM,DEPUTADO FEDERAL,PEN,1,0,1,0.0,1.0
680,2014,AM,DEPUTADO FEDERAL,PSDC,1,0,1,0.0,1.0
681,2014,AM,SENADOR,PSB,1,0,1,0.0,1.0
682,2014,AM,SENADOR,PT,1,0,1,0.0,1.0
683,2014,AM,SENADOR,PSTU,1,0,1,0.0,1.0
684,2014,AM,SENADOR,PMN,1,0,1,0.0,1.0
685,2014,AM,SENADOR,PSOL,1,0,1,0.0,1.0
686,2014,AM,SENADOR,PSD,1,0,1,0.0,1.0
687,2018,AM,DEPUTADO ESTADUAL,PHS,19,6,25,0.24,0.76
688,2018,AM,DEPUTADO ESTADUAL,PT,17,7,24,0.2916666666666667,0.7083333333333334
689,2018,AM,DEPUTADO ESTADUAL,PSL,15,5,20,0.25,0.75
690,2018,AM,DEPUTADO ESTADUAL,AVANTE,18,7,25,0.28,0.72
691,2018,AM,DEPUTADO ESTADUAL,PV,30,15,45,0.3333333333333333,0.6666666666666666
692,2018,AM,DEPUTADO ESTADUAL,REDE,12,5,17,0.29411764705882354,0.7058823529411765
693,2018,AM,DEPUTADO ESTADUAL,DEM,12,5,17,0.29411764705882354,0.7058823529411765
694,2018,AM,DEPUTADO ESTADUAL,PATRI,31,14,45,0.3111111111111111,0.6888888888888889
695,2018,AM,DEPUTADO ESTADUAL,PTB,1,4,5,0.8,0.2
696,2018,AM,DEPUTADO ESTADUAL,DC,21,8,29,0.27586206896551724,0.7241379310344828
697,2018,AM,DEPUTADO ESTADUAL,PPL,4,5,9,0.5555555555555556,0.4444444444444444
698,2018,AM,DEPUTADO ESTADUAL,PPS,28,12,40,0.3,0.7
699,2018,AM,DEPUTADO ESTADUAL,PSDB,12,6,18,0.3333333333333333,0.6666666666666666
700,2018,AM,DEPUTADO ESTADUAL,PMN,33,16,49,0.32653061224489793,0.673469387755102
701,2018,AM,DEPUTADO ESTADUAL,PSD,10,5,15,0.3333333333333333,0.6666666666666666
702,2018,AM,DEPUTADO ESTADUAL,PODE,20,10,30,0.3333333333333333,0.6666666666666666
703,2018,AM,DEPUTADO ESTADUAL,PSOL,21,11,32,0.34375,0.65625
704,2018,AM,DEPUTADO ESTADUAL,SOLIDARIEDADE,13,4,17,0.23529411764705882,0.7647058823529411
705,2018,AM,DEPUTADO ESTADUAL,PROS,8,1,9,0.1111111111111111,0.8888888888888888
706,2018,AM,DEPUTADO ESTADUAL,PSC,12,6,18,0.3333333333333333,0.6666666666666666
707,2018,AM,DEPUTADO ESTADUAL,PSB,20,12,32,0.375,0.625
708,2018,AM,DEPUTADO ESTADUAL,PRTB,8,3,11,0.2727272727272727,0.7272727272727273
709,2018,AM,DEPUTADO ESTADUAL,PC do B,15,6,21,0.2857142857142857,0.7142857142857143
710,2018,AM,DEPUTADO ESTADUAL,PRP,7,3,10,0.3,0.7
711,2018,AM,DEPUTADO ESTADUAL,PMB,3,1,4,0.25,0.75
712,2018,AM,DEPUTADO ESTADUAL,MDB,13,7,20,0.35,0.65
713,2018,AM,DEPUTADO ESTADUAL,PR,13,4,17,0.23529411764705882,0.7647058823529411
714,2018,AM,DEPUTADO ESTADUAL,PTC,12,5,17,0.29411764705882354,0.7058823529411765
715,2018,AM,DEPUTADO ESTADUAL,PDT,14,5,19,0.2631578947368421,0.7368421052631579
716,2018,AM,DEPUTADO ESTADUAL,PRB,3,2,5,0.4,0.6
717,2018,AM,DEPUTADO ESTADUAL,PP,7,2,9,0.2222222222222222,0.7777777777777778
718,2018,AM,DEPUTADO ESTADUAL,PSTU,1,0,1,0.0,1.0
719,2018,AM,DEPUTADO FEDERAL,PC do B,5,3,8,0.375,0.625
720,2018,AM,DEPUTADO FEDERAL,PSTU,1,0,1,0.0,1.0
721,2018,AM,DEPUTADO FEDERAL,MDB,4,5,9,0.5555555555555556,0.4444444444444444
722,2018,AM,DEPUTADO FEDERAL,REDE,5,2,7,0.2857142857142857,0.7142857142857143
723,2018,AM,DEPUTADO FEDERAL,PV,2,1,3,0.3333333333333333,0.6666666666666666
724,2018,AM,DEPUTADO FEDERAL,DC,7,0,7,0.0,1.0
725,2018,AM,DEPUTADO FEDERAL,PSB,1,2,3,0.6666666666666666,0.3333333333333333
726,2018,AM,DEPUTADO FEDERAL,PATRI,5,3,8,0.375,0.625
727,2018,AM,DEPUTADO FEDERAL,AVANTE,6,1,7,0.14285714285714285,0.8571428571428571
728,2018,AM,DEPUTADO FEDERAL,PSOL,11,4,15,0.26666666666666666,0.7333333333333333
729,2018,AM,DEPUTADO FEDERAL,PDT,8,4,12,0.3333333333333333,0.6666666666666666
730,2018,AM,DEPUTADO FEDERAL,PSC,3,2,5,0.4,0.6
731,2018,AM,DEPUTADO FEDERAL,DEM,1,1,2,0.5,0.5
732,2018,AM,DEPUTADO FEDERAL,PSD,4,0,4,0.0,1.0
733,2018,AM,DEPUTADO FEDERAL,PTB,1,0,1,0.0,1.0
734,2018,AM,DEPUTADO FEDERAL,PRP,4,1,5,0.2,0.8
735,2018,AM,DEPUTADO FEDERAL,PMB,7,4,11,0.36363636363636365,0.6363636363636364
736,2018,AM,DEPUTADO FEDERAL,PMN,5,1,6,0.16666666666666666,0.8333333333333334
737,2018,AM,DEPUTADO FEDERAL,PT,2,2,4,0.5,0.5
738,2018,AM,DEPUTADO FEDERAL,PODE,3,2,5,0.4,0.6
739,2018,AM,DEPUTADO FEDERAL,PTC,2,2,4,0.5,0.5
740,2018,AM,DEPUTADO FEDERAL,PPL,3,2,5,0.4,0.6
741,2018,AM,DEPUTADO FEDERAL,PSL,1,0,1,0.0,1.0
742,2018,AM,DEPUTADO FEDERAL,SOLIDARIEDADE,2,0,2,0.0,1.0
743,2018,AM,DEPUTADO FEDERAL,PHS,1,1,2,0.5,0.5
744,2018,AM,DEPUTADO FEDERAL,PR,1,2,3,0.6666666666666666,0.3333333333333333
745,2018,AM,DEPUTADO FEDERAL,PPS,1,1,2,0.5,0.5
746,2018,AM,DEPUTADO FEDERAL,PP,2,0,2,0.0,1.0
747,2018,AM,DEPUTADO FEDERAL,PRB,2,0,2,0.0,1.0
748,2018,AM,DEPUTADO FEDERAL,PROS,2,0,2,0.0,1.0
749,2018,AM,DEPUTADO FEDERAL,PRTB,2,1,3,0.3333333333333333,0.6666666666666666
750,2018,AM,DEPUTADO FEDERAL,PSDB,0,1,1,1.0,0.0
751,2018,AM,SENADOR,PSOL,2,0,2,0.0,1.0
752,2018,AM,SENADOR,PSDB,1,0,1,0.0,1.0
753,2018,AM,SENADOR,MDB,1,0,1,0.0,1.0
754,2018,AM,SENADOR,PDT,1,0,1,0.0,1.0
755,2018,AM,SENADOR,PC do B,0,1,1,1.0,0.0
756,2018,AM,SENADOR,REDE,1,0,1,0.0,1.0
757,2018,AM,SENADOR,PR,1,0,1,0.0,1.0
758,2018,AM,SENADOR,PMN,1,0,1,0.0,1.0
759,2010,BA,DEPUTADO ESTADUAL,PSDB,33,3,36,0.08333333333333333,0.9166666666666666
760,2010,BA,DEPUTADO ESTADUAL,PSL,15,13,28,0.4642857142857143,0.5357142857142857
761,2010,BA,DEPUTADO ESTADUAL,PRB,23,8,31,0.25806451612903225,0.7419354838709677
762,2010,BA,DEPUTADO ESTADUAL,PMDB,37,9,46,0.1956521739130435,0.8043478260869565
763,2010,BA,DEPUTADO ESTADUAL,PRP,24,5,29,0.1724137931034483,0.8275862068965517
764,2010,BA,DEPUTADO ESTADUAL,PP,8,1,9,0.1111111111111111,0.8888888888888888
765,2010,BA,DEPUTADO ESTADUAL,PSC,35,10,45,0.2222222222222222,0.7777777777777778
766,2010,BA,DEPUTADO ESTADUAL,PDT,23,6,29,0.20689655172413793,0.7931034482758621
767,2010,BA,DEPUTADO ESTADUAL,PMN,19,1,20,0.05,0.95
768,2010,BA,DEPUTADO ESTADUAL,PR,19,2,21,0.09523809523809523,0.9047619047619048
769,2010,BA,DEPUTADO ESTADUAL,PT do B,14,2,16,0.125,0.875
770,2010,BA,DEPUTADO ESTADUAL,PSDC,14,2,16,0.125,0.875
771,2010,BA,DEPUTADO ESTADUAL,PPS,20,4,24,0.16666666666666666,0.8333333333333334
772,2010,BA,DEPUTADO ESTADUAL,PC do B,35,5,40,0.125,0.875
773,2010,BA,DEPUTADO ESTADUAL,PT,33,6,39,0.15384615384615385,0.8461538461538461
774,2010,BA,DEPUTADO ESTADUAL,PTC,34,7,41,0.17073170731707318,0.8292682926829268
775,2010,BA,DEPUTADO ESTADUAL,PTB,16,2,18,0.1111111111111111,0.8888888888888888
776,2010,BA,DEPUTADO ESTADUAL,PTN,19,2,21,0.09523809523809523,0.9047619047619048
777,2010,BA,DEPUTADO ESTADUAL,PV,39,5,44,0.11363636363636363,0.8863636363636364
778,2010,BA,DEPUTADO ESTADUAL,PSB,30,6,36,0.16666666666666666,0.8333333333333334
779,2010,BA,DEPUTADO ESTADUAL,PHS,29,10,39,0.2564102564102564,0.7435897435897436
780,2010,BA,DEPUTADO ESTADUAL,DEM,24,6,30,0.2,0.8
781,2010,BA,DEPUTADO ESTADUAL,PSOL,24,2,26,0.07692307692307693,0.9230769230769231
782,2010,BA,DEPUTADO ESTADUAL,PRTB,5,0,5,0.0,1.0
783,2010,BA,DEPUTADO ESTADUAL,PSTU,1,1,2,0.5,0.5
784,2010,BA,DEPUTADO ESTADUAL,PCB,1,0,1,0.0,1.0
785,2010,BA,DEPUTADO FEDERAL,PRB,7,1,8,0.125,0.875
786,2010,BA,DEPUTADO FEDERAL,PSB,7,0,7,0.0,1.0
787,2010,BA,DEPUTADO FEDERAL,PT,19,2,21,0.09523809523809523,0.9047619047619048
788,2010,BA,DEPUTADO FEDERAL,PRP,11,1,12,0.08333333333333333,0.9166666666666666
789,2010,BA,DEPUTADO FEDERAL,PC do B,2,1,3,0.3333333333333333,0.6666666666666666
790,2010,BA,DEPUTADO FEDERAL,PT do B,8,0,8,0.0,1.0
791,2010,BA,DEPUTADO FEDERAL,DEM,18,1,19,0.05263157894736842,0.9473684210526315
792,2010,BA,DEPUTADO FEDERAL,PTC,16,3,19,0.15789473684210525,0.8421052631578947
793,2010,BA,DEPUTADO FEDERAL,PSOL,18,0,18,0.0,1.0
794,2010,BA,DEPUTADO FEDERAL,PSL,3,2,5,0.4,0.6
795,2010,BA,DEPUTADO FEDERAL,PR,9,1,10,0.1,0.9
796,2010,BA,DEPUTADO FEDERAL,PSDC,7,0,7,0.0,1.0
797,2010,BA,DEPUTADO FEDERAL,PRTB,5,0,5,0.0,1.0
798,2010,BA,DEPUTADO FEDERAL,PMN,6,0,6,0.0,1.0
799,2010,BA,DEPUTADO FEDERAL,PMDB,21,2,23,0.08695652173913043,0.9130434782608695
800,2010,BA,DEPUTADO FEDERAL,PDT,10,1,11,0.09090909090909091,0.9090909090909091
801,2010,BA,DEPUTADO FEDERAL,PSDB,17,8,25,0.32,0.68
802,2010,BA,DEPUTADO FEDERAL,PTB,6,0,6,0.0,1.0
803,2010,BA,DEPUTADO FEDERAL,PV,15,6,21,0.2857142857142857,0.7142857142857143
804,2010,BA,DEPUTADO FEDERAL,PSTU,1,0,1,0.0,1.0
805,2010,BA,DEPUTADO FEDERAL,PHS,2,0,2,0.0,1.0
806,2010,BA,DEPUTADO FEDERAL,PPS,12,1,13,0.07692307692307693,0.9230769230769231
807,2010,BA,DEPUTADO FEDERAL,PSC,14,3,17,0.17647058823529413,0.8235294117647058
808,2010,BA,DEPUTADO FEDERAL,PTN,5,0,5,0.0,1.0
809,2010,BA,DEPUTADO FEDERAL,PP,7,0,7,0.0,1.0
810,2010,BA,DEPUTADO FEDERAL,PCB,1,0,1,0.0,1.0
811,2010,BA,SENADOR,PSTU,1,0,1,0.0,1.0
812,2010,BA,SENADOR,PCB,1,0,1,0.0,1.0
813,2010,BA,SENADOR,PR,1,0,1,0.0,1.0
814,2010,BA,SENADOR,PV,1,0,1,0.0,1.0
815,2010,BA,SENADOR,PTB,1,0,1,0.0,1.0
816,2010,BA,SENADOR,DEM,2,0,2,0.0,1.0
817,2010,BA,SENADOR,PSB,0,1,1,1.0,0.0
818,2010,BA,SENADOR,PSOL,1,1,2,0.5,0.5
819,2010,BA,SENADOR,PT,1,0,1,0.0,1.0
820,2014,BA,DEPUTADO ESTADUAL,PSOL,27,12,39,0.3076923076923077,0.6923076923076923
821,2014,BA,DEPUTADO ESTADUAL,PPS,8,5,13,0.38461538461538464,0.6153846153846154
822,2014,BA,DEPUTADO ESTADUAL,PV,24,13,37,0.35135135135135137,0.6486486486486487
823,2014,BA,DEPUTADO ESTADUAL,PTB,11,5,16,0.3125,0.6875
824,2014,BA,DEPUTADO ESTADUAL,PEN,44,30,74,0.40540540540540543,0.5945945945945946
825,2014,BA,DEPUTADO ESTADUAL,PT,40,13,53,0.24528301886792453,0.7547169811320755
826,2014,BA,DEPUTADO ESTADUAL,PRB,11,11,22,0.5,0.5
827,2014,BA,DEPUTADO ESTADUAL,PSL,14,8,22,0.36363636363636365,0.6363636363636364
828,2014,BA,DEPUTADO ESTADUAL,PC do B,29,13,42,0.30952380952380953,0.6904761904761905
829,2014,BA,DEPUTADO ESTADUAL,PSD,10,5,15,0.3333333333333333,0.6666666666666666
830,2014,BA,DEPUTADO ESTADUAL,PMN,15,8,23,0.34782608695652173,0.6521739130434783
831,2014,BA,DEPUTADO ESTADUAL,PTC,33,12,45,0.26666666666666666,0.7333333333333333
832,2014,BA,DEPUTADO ESTADUAL,DEM,20,8,28,0.2857142857142857,0.7142857142857143
833,2014,BA,DEPUTADO ESTADUAL,PDT,11,7,18,0.3888888888888889,0.6111111111111112
834,2014,BA,DEPUTADO ESTADUAL,PP,9,4,13,0.3076923076923077,0.6923076923076923
835,2014,BA,DEPUTADO ESTADUAL,PRP,12,4,16,0.25,0.75
836,2014,BA,DEPUTADO ESTADUAL,PT do B,10,5,15,0.3333333333333333,0.6666666666666666
837,2014,BA,DEPUTADO ESTADUAL,PMDB,15,6,21,0.2857142857142857,0.7142857142857143
838,2014,BA,DEPUTADO ESTADUAL,PSB,29,11,40,0.275,0.725
839,2014,BA,DEPUTADO ESTADUAL,PSC,12,4,16,0.25,0.75
840,2014,BA,DEPUTADO ESTADUAL,PPL,6,2,8,0.25,0.75
841,2014,BA,DEPUTADO ESTADUAL,PTN,11,5,16,0.3125,0.6875
842,2014,BA,DEPUTADO ESTADUAL,PRTB,16,3,19,0.15789473684210525,0.8421052631578947
843,2014,BA,DEPUTADO ESTADUAL,PSDC,11,1,12,0.08333333333333333,0.9166666666666666
844,2014,BA,DEPUTADO ESTADUAL,PSTU,1,1,2,0.5,0.5
845,2014,BA,DEPUTADO ESTADUAL,PSDB,13,2,15,0.13333333333333333,0.8666666666666667
846,2014,BA,DEPUTADO ESTADUAL,PR,7,4,11,0.36363636363636365,0.6363636363636364
847,2014,BA,DEPUTADO ESTADUAL,SD,6,2,8,0.25,0.75
848,2014,BA,DEPUTADO ESTADUAL,PROS,4,1,5,0.2,0.8
849,2014,BA,DEPUTADO ESTADUAL,PHS,7,1,8,0.125,0.875
850,2014,BA,DEPUTADO FEDERAL,PSOL,26,14,40,0.35,0.65
851,2014,BA,DEPUTADO FEDERAL,PSB,11,7,18,0.3888888888888889,0.6111111111111112
852,2014,BA,DEPUTADO FEDERAL,DEM,17,6,23,0.2608695652173913,0.7391304347826086
853,2014,BA,DEPUTADO FEDERAL,PT do B,10,2,12,0.16666666666666666,0.8333333333333334
854,2014,BA,DEPUTADO FEDERAL,PTC,18,20,38,0.5263157894736842,0.47368421052631576
855,2014,BA,DEPUTADO FEDERAL,PSDC,6,1,7,0.14285714285714285,0.8571428571428571
856,2014,BA,DEPUTADO FEDERAL,PV,9,2,11,0.18181818181818182,0.8181818181818182
857,2014,BA,DEPUTADO FEDERAL,PDT,6,3,9,0.3333333333333333,0.6666666666666666
858,2014,BA,DEPUTADO FEDERAL,PT,16,6,22,0.2727272727272727,0.7272727272727273
859,2014,BA,DEPUTADO FEDERAL,PTB,2,1,3,0.3333333333333333,0.6666666666666666
860,2014,BA,DEPUTADO FEDERAL,PEN,24,15,39,0.38461538461538464,0.6153846153846154
861,2014,BA,DEPUTADO FEDERAL,PR,4,2,6,0.3333333333333333,0.6666666666666666
862,2014,BA,DEPUTADO FEDERAL,PP,5,2,7,0.2857142857142857,0.7142857142857143
863,2014,BA,DEPUTADO FEDERAL,PRTB,22,7,29,0.2413793103448276,0.7586206896551724
864,2014,BA,DEPUTADO FEDERAL,PHS,6,4,10,0.4,0.6
865,2014,BA,DEPUTADO FEDERAL,PRB,4,2,6,0.3333333333333333,0.6666666666666666
866,2014,BA,DEPUTADO FEDERAL,PSC,8,4,12,0.3333333333333333,0.6666666666666666
867,2014,BA,DEPUTADO FEDERAL,PMDB,10,5,15,0.3333333333333333,0.6666666666666666
868,2014,BA,DEPUTADO FEDERAL,PRP,13,3,16,0.1875,0.8125
869,2014,BA,DEPUTADO FEDERAL,PSDB,8,2,10,0.2,0.8
870,2014,BA,DEPUTADO FEDERAL,PSL,7,3,10,0.3,0.7
871,2014,BA,DEPUTADO FEDERAL,PPS,4,3,7,0.42857142857142855,0.5714285714285714
872,2014,BA,DEPUTADO FEDERAL,PTN,6,3,9,0.3333333333333333,0.6666666666666666
873,2014,BA,DEPUTADO FEDERAL,PSD,7,5,12,0.4166666666666667,0.5833333333333334
874,2014,BA,DEPUTADO FEDERAL,PC do B,2,1,3,0.3333333333333333,0.6666666666666666
875,2014,BA,DEPUTADO FEDERAL,PMN,1,0,1,0.0,1.0
876,2014,BA,DEPUTADO FEDERAL,PSTU,1,1,2,0.5,0.5
877,2014,BA,DEPUTADO FEDERAL,PROS,1,2,3,0.6666666666666666,0.3333333333333333
878,2014,BA,DEPUTADO FEDERAL,SD,5,1,6,0.16666666666666666,0.8333333333333334
879,2014,BA,DEPUTADO FEDERAL,PPL,1,0,1,0.0,1.0
880,2014,BA,SENADOR,PEN,2,1,3,0.3333333333333333,0.6666666666666666
881,2014,BA,SENADOR,PSOL,1,0,1,0.0,1.0
882,2014,BA,SENADOR,PSD,1,0,1,0.0,1.0
883,2014,BA,SENADOR,PSB,0,1,1,1.0,0.0
884,2014,BA,SENADOR,PMDB,1,0,1,0.0,1.0
885,2018,BA,DEPUTADO ESTADUAL,PP,11,4,15,0.26666666666666666,0.7333333333333333
886,2018,BA,DEPUTADO ESTADUAL,PHS,21,13,34,0.38235294117647056,0.6176470588235294
887,2018,BA,DEPUTADO ESTADUAL,PSC,27,13,40,0.325,0.675
888,2018,BA,DEPUTADO ESTADUAL,PTC,45,19,64,0.296875,0.703125
889,2018,BA,DEPUTADO ESTADUAL,PATRI,42,21,63,0.3333333333333333,0.6666666666666666
890,2018,BA,DEPUTADO ESTADUAL,PSL,21,6,27,0.2222222222222222,0.7777777777777778
891,2018,BA,DEPUTADO ESTADUAL,REDE,13,3,16,0.1875,0.8125
892,2018,BA,DEPUTADO ESTADUAL,PTB,7,5,12,0.4166666666666667,0.5833333333333334
893,2018,BA,DEPUTADO ESTADUAL,PC do B,29,15,44,0.3409090909090909,0.6590909090909091
894,2018,BA,DEPUTADO ESTADUAL,PT,17,9,26,0.34615384615384615,0.6538461538461539
895,2018,BA,DEPUTADO ESTADUAL,PSB,8,4,12,0.3333333333333333,0.6666666666666666
896,2018,BA,DEPUTADO ESTADUAL,PDT,7,2,9,0.2222222222222222,0.7777777777777778
897,2018,BA,DEPUTADO ESTADUAL,DEM,23,6,29,0.20689655172413793,0.7931034482758621
898,2018,BA,DEPUTADO ESTADUAL,SOLIDARIEDADE,22,9,31,0.2903225806451613,0.7096774193548387
899,2018,BA,DEPUTADO ESTADUAL,PV,7,6,13,0.46153846153846156,0.5384615384615384
900,2018,BA,DEPUTADO ESTADUAL,PSOL,33,14,47,0.2978723404255319,0.7021276595744681
901,2018,BA,DEPUTADO ESTADUAL,DC,17,8,25,0.32,0.68
902,2018,BA,DEPUTADO ESTADUAL,PSDB,9,5,14,0.35714285714285715,0.6428571428571429
903,2018,BA,DEPUTADO ESTADUAL,PODE,6,3,9,0.3333333333333333,0.6666666666666666
904,2018,BA,DEPUTADO ESTADUAL,PPL,8,3,11,0.2727272727272727,0.7272727272727273
905,2018,BA,DEPUTADO ESTADUAL,MDB,14,9,23,0.391304347826087,0.6086956521739131
906,2018,BA,DEPUTADO ESTADUAL,PR,5,1,6,0.16666666666666666,0.8333333333333334
907,2018,BA,DEPUTADO ESTADUAL,PRB,12,5,17,0.29411764705882354,0.7058823529411765
908,2018,BA,DEPUTADO ESTADUAL,PPS,8,2,10,0.2,0.8
909,2018,BA,DEPUTADO ESTADUAL,PSD,8,5,13,0.38461538461538464,0.6153846153846154
910,2018,BA,DEPUTADO ESTADUAL,PROS,2,2,4,0.5,0.5
911,2018,BA,DEPUTADO ESTADUAL,PRP,6,0,6,0.0,1.0
912,2018,BA,DEPUTADO ESTADUAL,AVANTE,2,0,2,0.0,1.0
913,2018,BA,DEPUTADO ESTADUAL,PRTB,11,3,14,0.21428571428571427,0.7857142857142857
914,2018,BA,DEPUTADO ESTADUAL,PMN,2,1,3,0.3333333333333333,0.6666666666666666
915,2018,BA,DEPUTADO ESTADUAL,PCO,1,0,1,0.0,1.0
916,2018,BA,DEPUTADO ESTADUAL,PMB,0,1,1,1.0,0.0
917,2018,BA,DEPUTADO FEDERAL,DC,10,6,16,0.375,0.625
918,2018,BA,DEPUTADO FEDERAL,DEM,29,14,43,0.32558139534883723,0.6744186046511628
919,2018,BA,DEPUTADO FEDERAL,PSOL,33,18,51,0.35294117647058826,0.6470588235294118
920,2018,BA,DEPUTADO FEDERAL,PTC,22,7,29,0.2413793103448276,0.7586206896551724
921,2018,BA,DEPUTADO FEDERAL,PHS,18,8,26,0.3076923076923077,0.6923076923076923
922,2018,BA,DEPUTADO FEDERAL,PRP,6,6,12,0.5,0.5
923,2018,BA,DEPUTADO FEDERAL,PDT,26,12,38,0.3157894736842105,0.6842105263157895
924,2018,BA,DEPUTADO FEDERAL,MDB,29,12,41,0.2926829268292683,0.7073170731707317
925,2018,BA,DEPUTADO FEDERAL,PATRI,28,12,40,0.3,0.7
926,2018,BA,DEPUTADO FEDERAL,PSC,5,4,9,0.4444444444444444,0.5555555555555556
927,2018,BA,DEPUTADO FEDERAL,PSD,7,3,10,0.3,0.7
928,2018,BA,DEPUTADO FEDERAL,PPL,5,5,10,0.5,0.5
929,2018,BA,DEPUTADO FEDERAL,PMN,6,2,8,0.25,0.75
930,2018,BA,DEPUTADO FEDERAL,REDE,14,6,20,0.3,0.7
931,2018,BA,DEPUTADO FEDERAL,AVANTE,10,5,15,0.3333333333333333,0.6666666666666666
932,2018,BA,DEPUTADO FEDERAL,PRTB,10,3,13,0.23076923076923078,0.7692307692307693
933,2018,BA,DEPUTADO FEDERAL,PSDB,6,5,11,0.45454545454545453,0.5454545454545454
934,2018,BA,DEPUTADO FEDERAL,PR,4,0,4,0.0,1.0
935,2018,BA,DEPUTADO FEDERAL,SOLIDARIEDADE,6,0,6,0.0,1.0
936,2018,BA,DEPUTADO FEDERAL,PRB,2,2,4,0.5,0.5
937,2018,BA,DEPUTADO FEDERAL,PV,7,5,12,0.4166666666666667,0.5833333333333334
938,2018,BA,DEPUTADO FEDERAL,PODE,2,2,4,0.5,0.5
939,2018,BA,DEPUTADO FEDERAL,PP,5,3,8,0.375,0.625
940,2018,BA,DEPUTADO FEDERAL,PCO,1,1,2,0.5,0.5
941,2018,BA,DEPUTADO FEDERAL,PROS,9,6,15,0.4,0.6
942,2018,BA,DEPUTADO FEDERAL,NOVO,5,3,8,0.375,0.625
943,2018,BA,DEPUTADO FEDERAL,PT,10,4,14,0.2857142857142857,0.7142857142857143
944,2018,BA,DEPUTADO FEDERAL,PC do B,2,1,3,0.3333333333333333,0.6666666666666666
945,2018,BA,DEPUTADO FEDERAL,PSB,4,2,6,0.3333333333333333,0.6666666666666666
946,2018,BA,DEPUTADO FEDERAL,PSL,11,3,14,0.21428571428571427,0.7857142857142857
947,2018,BA,DEPUTADO FEDERAL,PTB,2,2,4,0.5,0.5
948,2018,BA,DEPUTADO FEDERAL,PPS,1,1,2,0.5,0.5
949,2018,BA,DEPUTADO FEDERAL,PMB,0,1,1,1.0,0.0
950,2018,BA,SENADOR,REDE,1,0,1,0.0,1.0
951,2018,BA,SENADOR,DC,1,0,1,0.0,1.0
952,2018,BA,SENADOR,MDB,1,0,1,0.0,1.0
953,2018,BA,SENADOR,PCO,1,0,1,0.0,1.0
954,2018,BA,SENADOR,PSDB,1,0,1,0.0,1.0
955,2018,BA,SENADOR,PRTB,1,0,1,0.0,1.0
956,2018,BA,SENADOR,PSOL,1,0,1,0.0,1.0
957,2018,BA,SENADOR,PSC,1,0,1,0.0,1.0
958,2018,BA,SENADOR,PSL,1,0,1,0.0,1.0
959,2018,BA,SENADOR,PT,1,0,1,0.0,1.0
960,2018,BA,SENADOR,PSD,1,0,1,0.0,1.0
961,2010,CE,DEPUTADO ESTADUAL,PR,29,10,39,0.2564102564102564,0.7435897435897436
962,2010,CE,DEPUTADO ESTADUAL,PC do B,17,9,26,0.34615384615384615,0.6538461538461539
963,2010,CE,DEPUTADO ESTADUAL,PV,26,11,37,0.2972972972972973,0.7027027027027027
964,2010,CE,DEPUTADO ESTADUAL,PMN,17,8,25,0.32,0.68
965,2010,CE,DEPUTADO ESTADUAL,PTC,39,13,52,0.25,0.75
966,2010,CE,DEPUTADO ESTADUAL,DEM,25,12,37,0.32432432432432434,0.6756756756756757
967,2010,CE,DEPUTADO ESTADUAL,PHS,12,4,16,0.25,0.75
968,2010,CE,DEPUTADO ESTADUAL,PSDB,15,8,23,0.34782608695652173,0.6521739130434783
969,2010,CE,DEPUTADO ESTADUAL,PTB,24,6,30,0.2,0.8
970,2010,CE,DEPUTADO ESTADUAL,PTN,47,17,64,0.265625,0.734375
971,2010,CE,DEPUTADO ESTADUAL,PSOL,24,9,33,0.2727272727272727,0.7272727272727273
972,2010,CE,DEPUTADO ESTADUAL,PSB,16,7,23,0.30434782608695654,0.6956521739130435
973,2010,CE,DEPUTADO ESTADUAL,PT,17,6,23,0.2608695652173913,0.7391304347826086
974,2010,CE,DEPUTADO ESTADUAL,PSC,8,2,10,0.2,0.8
975,2010,CE,DEPUTADO ESTADUAL,PP,12,4,16,0.25,0.75
976,2010,CE,DEPUTADO ESTADUAL,PSL,9,3,12,0.25,0.75
977,2010,CE,DEPUTADO ESTADUAL,PRB,8,4,12,0.3333333333333333,0.6666666666666666
978,2010,CE,DEPUTADO ESTADUAL,PPS,8,6,14,0.42857142857142855,0.5714285714285714
979,2010,CE,DEPUTADO ESTADUAL,PSDC,12,3,15,0.2,0.8
980,2010,CE,DEPUTADO ESTADUAL,PDT,25,11,36,0.3055555555555556,0.6944444444444444
981,2010,CE,DEPUTADO ESTADUAL,PRP,6,3,9,0.3333333333333333,0.6666666666666666
982,2010,CE,DEPUTADO ESTADUAL,PT do B,8,4,12,0.3333333333333333,0.6666666666666666
983,2010,CE,DEPUTADO ESTADUAL,PMDB,8,6,14,0.42857142857142855,0.5714285714285714
984,2010,CE,DEPUTADO ESTADUAL,PRTB,10,7,17,0.4117647058823529,0.5882352941176471
985,2010,CE,DEPUTADO ESTADUAL,PSTU,2,0,2,0.0,1.0
986,2010,CE,DEPUTADO ESTADUAL,PCB,4,2,6,0.3333333333333333,0.6666666666666666
987,2010,CE,DEPUTADO FEDERAL,PSOL,5,2,7,0.2857142857142857,0.7142857142857143
988,2010,CE,DEPUTADO FEDERAL,PR,10,4,14,0.2857142857142857,0.7142857142857143
989,2010,CE,DEPUTADO FEDERAL,PSB,5,1,6,0.16666666666666666,0.8333333333333334
990,2010,CE,DEPUTADO FEDERAL,PPS,3,2,5,0.4,0.6
991,2010,CE,DEPUTADO FEDERAL,PSTU,1,1,2,0.5,0.5
992,2010,CE,DEPUTADO FEDERAL,PDT,2,1,3,0.3333333333333333,0.6666666666666666
993,2010,CE,DEPUTADO FEDERAL,PSDB,9,5,14,0.35714285714285715,0.6428571428571429
994,2010,CE,DEPUTADO FEDERAL,PMDB,10,5,15,0.3333333333333333,0.6666666666666666
995,2010,CE,DEPUTADO FEDERAL,PTB,2,1,3,0.3333333333333333,0.6666666666666666
996,2010,CE,DEPUTADO FEDERAL,PP,4,1,5,0.2,0.8
997,2010,CE,DEPUTADO FEDERAL,DEM,6,2,8,0.25,0.75
998,2010,CE,DEPUTADO FEDERAL,PRTB,4,0,4,0.0,1.0
999,2010,CE,DEPUTADO FEDERAL,PT,6,2,8,0.25,0.75
1000,2010,CE,DEPUTADO FEDERAL,PV,16,2,18,0.1111111111111111,0.8888888888888888
1001,2010,CE,DEPUTADO FEDERAL,PT do B,1,0,1,0.0,1.0
1002,2010,CE,DEPUTADO FEDERAL,PMN,3,0,3,0.0,1.0
1003,2010,CE,DEPUTADO FEDERAL,PC do B,2,2,4,0.5,0.5
1004,2010,CE,DEPUTADO FEDERAL,PSL,4,1,5,0.2,0.8
1005,2010,CE,DEPUTADO FEDERAL,PHS,6,2,8,0.25,0.75
1006,2010,CE,DEPUTADO FEDERAL,PTC,6,2,8,0.25,0.75
1007,2010,CE,DEPUTADO FEDERAL,PSC,1,1,2,0.5,0.5
1008,2010,CE,DEPUTADO FEDERAL,PRB,2,1,3,0.3333333333333333,0.6666666666666666
1009,2010,CE,DEPUTADO FEDERAL,PTN,2,1,3,0.3333333333333333,0.6666666666666666
1010,2010,CE,DEPUTADO FEDERAL,PRP,3,0,3,0.0,1.0
1011,2010,CE,DEPUTADO FEDERAL,PCB,1,1,2,0.5,0.5
1012,2010,CE,SENADOR,PPS,1,0,1,0.0,1.0
1013,2010,CE,SENADOR,PCB,2,0,2,0.0,1.0
1014,2010,CE,SENADOR,PMDB,1,0,1,0.0,1.0
1015,2010,CE,SENADOR,PT,1,0,1,0.0,1.0
1016,2010,CE,SENADOR,PSOL,0,1,1,1.0,0.0
1017,2010,CE,SENADOR,PV,1,0,1,0.0,1.0
1018,2010,CE,SENADOR,PSTU,1,1,2,0.5,0.5
1019,2010,CE,SENADOR,PSDB,1,0,1,0.0,1.0
1020,2014,CE,DEPUTADO ESTADUAL,PDT,22,10,32,0.3125,0.6875
1021,2014,CE,DEPUTADO ESTADUAL,PSOL,23,13,36,0.3611111111111111,0.6388888888888888
1022,2014,CE,DEPUTADO ESTADUAL,PTN,24,11,35,0.3142857142857143,0.6857142857142857
1023,2014,CE,DEPUTADO ESTADUAL,PRTB,8,1,9,0.1111111111111111,0.8888888888888888
1024,2014,CE,DEPUTADO ESTADUAL,PC do B,27,13,40,0.325,0.675
1025,2014,CE,DEPUTADO ESTADUAL,PSC,46,20,66,0.30303030303030304,0.696969696969697
1026,2014,CE,DEPUTADO ESTADUAL,PP,15,5,20,0.25,0.75
1027,2014,CE,DEPUTADO ESTADUAL,PTC,40,23,63,0.36507936507936506,0.6349206349206349
1028,2014,CE,DEPUTADO ESTADUAL,PMN,9,5,14,0.35714285714285715,0.6428571428571429
1029,2014,CE,DEPUTADO ESTADUAL,PMDB,18,10,28,0.35714285714285715,0.6428571428571429
1030,2014,CE,DEPUTADO ESTADUAL,PHS,3,2,5,0.4,0.6
1031,2014,CE,DEPUTADO ESTADUAL,PR,17,8,25,0.32,0.68
1032,2014,CE,DEPUTADO ESTADUAL,PSDB,15,4,19,0.21052631578947367,0.7894736842105263
1033,2014,CE,DEPUTADO ESTADUAL,PV,8,3,11,0.2727272727272727,0.7272727272727273
1034,2014,CE,DEPUTADO ESTADUAL,PRB,7,3,10,0.3,0.7
1035,2014,CE,DEPUTADO ESTADUAL,PPS,14,6,20,0.3,0.7
1036,2014,CE,DEPUTADO ESTADUAL,PSDC,16,7,23,0.30434782608695654,0.6956521739130435
1037,2014,CE,DEPUTADO ESTADUAL,PPL,11,3,14,0.21428571428571427,0.7857142857142857
1038,2014,CE,DEPUTADO ESTADUAL,PEN,31,16,47,0.3404255319148936,0.6595744680851063
1039,2014,CE,DEPUTADO ESTADUAL,PSD,7,1,8,0.125,0.875
1040,2014,CE,DEPUTADO ESTADUAL,DEM,11,5,16,0.3125,0.6875
1041,2014,CE,DEPUTADO ESTADUAL,PRP,5,1,6,0.16666666666666666,0.8333333333333334
1042,2014,CE,DEPUTADO ESTADUAL,PT,11,5,16,0.3125,0.6875
1043,2014,CE,DEPUTADO ESTADUAL,PTB,5,3,8,0.375,0.625
1044,2014,CE,DEPUTADO ESTADUAL,PSL,4,7,11,0.6363636363636364,0.36363636363636365
1045,2014,CE,DEPUTADO ESTADUAL,SD,6,1,7,0.14285714285714285,0.8571428571428571
1046,2014,CE,DEPUTADO ESTADUAL,PROS,18,4,22,0.18181818181818182,0.8181818181818182
1047,2014,CE,DEPUTADO ESTADUAL,PCB,1,1,2,0.5,0.5
1048,2014,CE,DEPUTADO ESTADUAL,PSB,3,2,5,0.4,0.6
1049,2014,CE,DEPUTADO ESTADUAL,PT do B,11,5,16,0.3125,0.6875
1050,2014,CE,DEPUTADO ESTADUAL,PSTU,2,1,3,0.3333333333333333,0.6666666666666666
1051,2014,CE,DEPUTADO FEDERAL,PSB,20,9,29,0.3103448275862069,0.6896551724137931
1052,2014,CE,DEPUTADO FEDERAL,PROS,7,2,9,0.2222222222222222,0.7777777777777778
1053,2014,CE,DEPUTADO FEDERAL,PMN,3,2,5,0.4,0.6
1054,2014,CE,DEPUTADO FEDERAL,PRTB,3,2,5,0.4,0.6
1055,2014,CE,DEPUTADO FEDERAL,PEN,7,2,9,0.2222222222222222,0.7777777777777778
1056,2014,CE,DEPUTADO FEDERAL,PV,6,3,9,0.3333333333333333,0.6666666666666666
1057,2014,CE,DEPUTADO FEDERAL,PSDC,4,0,4,0.0,1.0
1058,2014,CE,DEPUTADO FEDERAL,PTN,8,5,13,0.38461538461538464,0.6153846153846154
1059,2014,CE,DEPUTADO FEDERAL,PP,3,2,5,0.4,0.6
1060,2014,CE,DEPUTADO FEDERAL,PTB,1,2,3,0.6666666666666666,0.3333333333333333
1061,2014,CE,DEPUTADO FEDERAL,PMDB,9,6,15,0.4,0.6
1062,2014,CE,DEPUTADO FEDERAL,PR,6,2,8,0.25,0.75
1063,2014,CE,DEPUTADO FEDERAL,PSC,5,2,7,0.2857142857142857,0.7142857142857143
1064,2014,CE,DEPUTADO FEDERAL,PRP,3,0,3,0.0,1.0
1065,2014,CE,DEPUTADO FEDERAL,PSDB,6,3,9,0.3333333333333333,0.6666666666666666
1066,2014,CE,DEPUTADO FEDERAL,PTC,8,3,11,0.2727272727272727,0.7272727272727273
1067,2014,CE,DEPUTADO FEDERAL,PSL,2,1,3,0.3333333333333333,0.6666666666666666
1068,2014,CE,DEPUTADO FEDERAL,PSOL,10,5,15,0.3333333333333333,0.6666666666666666
1069,2014,CE,DEPUTADO FEDERAL,PT do B,3,1,4,0.25,0.75
1070,2014,CE,DEPUTADO FEDERAL,PSTU,7,3,10,0.3,0.7
1071,2014,CE,DEPUTADO FEDERAL,SD,2,0,2,0.0,1.0
1072,2014,CE,DEPUTADO FEDERAL,PT,7,3,10,0.3,0.7
1073,2014,CE,DEPUTADO FEDERAL,PRB,2,1,3,0.3333333333333333,0.6666666666666666
1074,2014,CE,DEPUTADO FEDERAL,PSD,4,0,4,0.0,1.0
1075,2014,CE,DEPUTADO FEDERAL,PDT,2,0,2,0.0,1.0
1076,2014,CE,DEPUTADO FEDERAL,DEM,6,2,8,0.25,0.75
1077,2014,CE,DEPUTADO FEDERAL,PPS,2,2,4,0.5,0.5
1078,2014,CE,DEPUTADO FEDERAL,PPL,1,0,1,0.0,1.0
1079,2014,CE,DEPUTADO FEDERAL,PC do B,3,1,4,0.25,0.75
1080,2014,CE,DEPUTADO FEDERAL,PHS,1,1,2,0.5,0.5
1081,2014,CE,DEPUTADO FEDERAL,PCB,1,0,1,0.0,1.0
1082,2014,CE,SENADOR,PROS,1,0,1,0.0,1.0
1083,2014,CE,SENADOR,PSDB,1,0,1,0.0,1.0
1084,2014,CE,SENADOR,PSTU,0,1,1,1.0,0.0
1085,2014,CE,SENADOR,PSB,0,1,1,1.0,0.0
1086,2018,CE,DEPUTADO ESTADUAL,PT,20,8,28,0.2857142857142857,0.7142857142857143
1087,2018,CE,DEPUTADO ESTADUAL,PRB,4,4,8,0.5,0.5
1088,2018,CE,DEPUTADO ESTADUAL,PDT,24,8,32,0.25,0.75
1089,2018,CE,DEPUTADO ESTADUAL,PATRI,38,16,54,0.2962962962962963,0.7037037037037037
1090,2018,CE,DEPUTADO ESTADUAL,PROS,44,20,64,0.3125,0.6875
1091,2018,CE,DEPUTADO ESTADUAL,PTC,23,10,33,0.30303030303030304,0.696969696969697
1092,2018,CE,DEPUTADO ESTADUAL,DC,16,12,28,0.42857142857142855,0.5714285714285714
1093,2018,CE,DEPUTADO ESTADUAL,PC do B,21,10,31,0.3225806451612903,0.6774193548387096
1094,2018,CE,DEPUTADO ESTADUAL,PPS,24,12,36,0.3333333333333333,0.6666666666666666
1095,2018,CE,DEPUTADO ESTADUAL,PSB,8,3,11,0.2727272727272727,0.7272727272727273
1096,2018,CE,DEPUTADO ESTADUAL,PSL,32,9,41,0.21951219512195122,0.7804878048780488
1097,2018,CE,DEPUTADO ESTADUAL,PSOL,23,10,33,0.30303030303030304,0.696969696969697
1098,2018,CE,DEPUTADO ESTADUAL,PR,6,6,12,0.5,0.5
1099,2018,CE,DEPUTADO ESTADUAL,DEM,4,5,9,0.5555555555555556,0.4444444444444444
1100,2018,CE,DEPUTADO ESTADUAL,PPL,12,3,15,0.2,0.8
1101,2018,CE,DEPUTADO ESTADUAL,PMN,23,10,33,0.30303030303030304,0.696969696969697
1102,2018,CE,DEPUTADO ESTADUAL,PRTB,5,2,7,0.2857142857142857,0.7142857142857143
1103,2018,CE,DEPUTADO ESTADUAL,AVANTE,11,3,14,0.21428571428571427,0.7857142857142857
1104,2018,CE,DEPUTADO ESTADUAL,PHS,2,0,2,0.0,1.0
1105,2018,CE,DEPUTADO ESTADUAL,PODE,11,6,17,0.35294117647058826,0.6470588235294118
1106,2018,CE,DEPUTADO ESTADUAL,PSDB,13,6,19,0.3157894736842105,0.6842105263157895
1107,2018,CE,DEPUTADO ESTADUAL,MDB,13,4,17,0.23529411764705882,0.7647058823529411
1108,2018,CE,DEPUTADO ESTADUAL,PSD,4,2,6,0.3333333333333333,0.6666666666666666
1109,2018,CE,DEPUTADO ESTADUAL,SOLIDARIEDADE,2,1,3,0.3333333333333333,0.6666666666666666
1110,2018,CE,DEPUTADO ESTADUAL,PV,9,6,15,0.4,0.6
1111,2018,CE,DEPUTADO ESTADUAL,PP,7,1,8,0.125,0.875
1112,2018,CE,DEPUTADO ESTADUAL,REDE,4,2,6,0.3333333333333333,0.6666666666666666
1113,2018,CE,DEPUTADO ESTADUAL,PSTU,3,2,5,0.4,0.6
1114,2018,CE,DEPUTADO ESTADUAL,PTB,2,1,3,0.3333333333333333,0.6666666666666666
1115,2018,CE,DEPUTADO ESTADUAL,PSC,1,1,2,0.5,0.5
1116,2018,CE,DEPUTADO ESTADUAL,PRP,2,0,2,0.0,1.0
1117,2018,CE,DEPUTADO ESTADUAL,PCO,1,0,1,0.0,1.0
1118,2018,CE,DEPUTADO FEDERAL,PRTB,4,1,5,0.2,0.8
1119,2018,CE,DEPUTADO FEDERAL,PSOL,17,8,25,0.32,0.68
1120,2018,CE,DEPUTADO FEDERAL,PT,7,5,12,0.4166666666666667,0.5833333333333334
1121,2018,CE,DEPUTADO FEDERAL,PSL,16,10,26,0.38461538461538464,0.6153846153846154
1122,2018,CE,DEPUTADO FEDERAL,NOVO,4,2,6,0.3333333333333333,0.6666666666666666
1123,2018,CE,DEPUTADO FEDERAL,PSD,4,1,5,0.2,0.8
1124,2018,CE,DEPUTADO FEDERAL,PROS,21,9,30,0.3,0.7
1125,2018,CE,DEPUTADO FEDERAL,AVANTE,5,1,6,0.16666666666666666,0.8333333333333334
1126,2018,CE,DEPUTADO FEDERAL,PHS,4,1,5,0.2,0.8
1127,2018,CE,DEPUTADO FEDERAL,REDE,11,5,16,0.3125,0.6875
1128,2018,CE,DEPUTADO FEDERAL,PSDB,9,4,13,0.3076923076923077,0.6923076923076923
1129,2018,CE,DEPUTADO FEDERAL,MDB,3,6,9,0.6666666666666666,0.3333333333333333
1130,2018,CE,DEPUTADO FEDERAL,PPS,3,3,6,0.5,0.5
1131,2018,CE,DEPUTADO FEDERAL,PATRI,15,6,21,0.2857142857142857,0.7142857142857143
1132,2018,CE,DEPUTADO FEDERAL,PTC,7,3,10,0.3,0.7
1133,2018,CE,DEPUTADO FEDERAL,PC do B,3,0,3,0.0,1.0
1134,2018,CE,DEPUTADO FEDERAL,PDT,10,4,14,0.2857142857142857,0.7142857142857143
1135,2018,CE,DEPUTADO FEDERAL,DC,7,0,7,0.0,1.0
1136,2018,CE,DEPUTADO FEDERAL,PRP,3,1,4,0.25,0.75
1137,2018,CE,DEPUTADO FEDERAL,PMN,2,2,4,0.5,0.5
1138,2018,CE,DEPUTADO FEDERAL,DEM,3,3,6,0.5,0.5
1139,2018,CE,DEPUTADO FEDERAL,PP,2,2,4,0.5,0.5
1140,2018,CE,DEPUTADO FEDERAL,PV,1,1,2,0.5,0.5
1141,2018,CE,DEPUTADO FEDERAL,PRB,1,0,1,0.0,1.0
1142,2018,CE,DEPUTADO FEDERAL,PSB,2,1,3,0.3333333333333333,0.6666666666666666
1143,2018,CE,DEPUTADO FEDERAL,PR,3,2,5,0.4,0.6
1144,2018,CE,DEPUTADO FEDERAL,PTB,1,1,2,0.5,0.5
1145,2018,CE,DEPUTADO FEDERAL,PODE,3,0,3,0.0,1.0
1146,2018,CE,DEPUTADO FEDERAL,SOLIDARIEDADE,2,0,2,0.0,1.0
1147,2018,CE,DEPUTADO FEDERAL,PSC,0,1,1,1.0,0.0
1148,2018,CE,DEPUTADO FEDERAL,PPL,3,0,3,0.0,1.0
1149,2018,CE,DEPUTADO FEDERAL,PSTU,1,0,1,0.0,1.0
1150,2018,CE,DEPUTADO FEDERAL,PCO,0,1,1,1.0,0.0
1151,2018,CE,DEPUTADO FEDERAL,PCB,1,0,1,0.0,1.0
1152,2018,CE,SENADOR,PTC,1,0,1,0.0,1.0
1153,2018,CE,SENADOR,PSOL,1,1,2,0.5,0.5
1154,2018,CE,SENADOR,PSL,2,0,2,0.0,1.0
1155,2018,CE,SENADOR,PSDB,0,1,1,1.0,0.0
1156,2018,CE,SENADOR,PROS,1,0,1,0.0,1.0
1157,2018,CE,SENADOR,PCO,1,0,1,0.0,1.0
1158,2018,CE,SENADOR,REDE,1,0,1,0.0,1.0
1159,2018,CE,SENADOR,PDT,1,0,1,0.0,1.0
1160,2018,CE,SENADOR,MDB,1,0,1,0.0,1.0
1161,2018,CE,SENADOR,PODE,1,0,1,0.0,1.0
1162,2018,CE,SENADOR,PSTU,1,0,1,0.0,1.0
1163,2010,DF,DEPUTADO DISTRITAL,PDT,33,15,48,0.3125,0.6875
1164,2010,DF,DEPUTADO DISTRITAL,PTB,39,9,48,0.1875,0.8125
1165,2010,DF,DEPUTADO DISTRITAL,PV,33,15,48,0.3125,0.6875
1166,2010,DF,DEPUTADO DISTRITAL,PRTB,22,7,29,0.2413793103448276,0.7586206896551724
1167,2010,DF,DEPUTADO DISTRITAL,PTC,25,7,32,0.21875,0.78125
1168,2010,DF,DEPUTADO DISTRITAL,PSL,35,8,43,0.18604651162790697,0.813953488372093
1169,2010,DF,DEPUTADO DISTRITAL,PP,26,9,35,0.2571428571428571,0.7428571428571429
1170,2010,DF,DEPUTADO DISTRITAL,PRP,25,3,28,0.10714285714285714,0.8928571428571429
1171,2010,DF,DEPUTADO DISTRITAL,PR,34,15,49,0.30612244897959184,0.6938775510204082
1172,2010,DF,DEPUTADO DISTRITAL,PSC,37,15,52,0.28846153846153844,0.7115384615384616
1173,2010,DF,DEPUTADO DISTRITAL,PPS,18,4,22,0.18181818181818182,0.8181818181818182
1174,2010,DF,DEPUTADO DISTRITAL,PHS,36,12,48,0.25,0.75
1175,2010,DF,DEPUTADO DISTRITAL,PT,33,7,40,0.175,0.825
1176,2010,DF,DEPUTADO DISTRITAL,PTN,10,4,14,0.2857142857142857,0.7142857142857143
1177,2010,DF,DEPUTADO DISTRITAL,PMN,27,13,40,0.325,0.675
1178,2010,DF,DEPUTADO DISTRITAL,PSDB,33,8,41,0.1951219512195122,0.8048780487804879
1179,2010,DF,DEPUTADO DISTRITAL,PSB,25,9,34,0.2647058823529412,0.7352941176470589
1180,2010,DF,DEPUTADO DISTRITAL,PT do B,39,14,53,0.2641509433962264,0.7358490566037735
1181,2010,DF,DEPUTADO DISTRITAL,PSDC,16,7,23,0.30434782608695654,0.6956521739130435
1182,2010,DF,DEPUTADO DISTRITAL,PMDB,35,13,48,0.2708333333333333,0.7291666666666666
1183,2010,DF,DEPUTADO DISTRITAL,PRB,11,3,14,0.21428571428571427,0.7857142857142857
1184,2010,DF,DEPUTADO DISTRITAL,PC do B,26,11,37,0.2972972972972973,0.7027027027027027
1185,2010,DF,DEPUTADO DISTRITAL,PSOL,18,3,21,0.14285714285714285,0.8571428571428571
1186,2010,DF,DEPUTADO DISTRITAL,PSTU,1,1,2,0.5,0.5
1187,2010,DF,DEPUTADO DISTRITAL,DEM,21,12,33,0.36363636363636365,0.6363636363636364
1188,2010,DF,DEPUTADO DISTRITAL,PCO,1,0,1,0.0,1.0
1189,2010,DF,DEPUTADO DISTRITAL,PCB,1,0,1,0.0,1.0
1190,2010,DF,DEPUTADO FEDERAL,DEM,3,0,3,0.0,1.0
1191,2010,DF,DEPUTADO FEDERAL,PSOL,8,3,11,0.2727272727272727,0.7272727272727273
1192,2010,DF,DEPUTADO FEDERAL,PSL,4,2,6,0.3333333333333333,0.6666666666666666
1193,2010,DF,DEPUTADO FEDERAL,PDT,7,0,7,0.0,1.0
1194,2010,DF,DEPUTADO FEDERAL,PMN,1,1,2,0.5,0.5
1195,2010,DF,DEPUTADO FEDERAL,PRTB,3,1,4,0.25,0.75
1196,2010,DF,DEPUTADO FEDERAL,PV,4,2,6,0.3333333333333333,0.6666666666666666
1197,2010,DF,DEPUTADO FEDERAL,PSDC,2,1,3,0.3333333333333333,0.6666666666666666
1198,2010,DF,DEPUTADO FEDERAL,PTB,9,1,10,0.1,0.9
1199,2010,DF,DEPUTADO FEDERAL,PHS,11,2,13,0.15384615384615385,0.8461538461538461
1200,2010,DF,DEPUTADO FEDERAL,PPS,3,0,3,0.0,1.0
1201,2010,DF,DEPUTADO FEDERAL,PT,6,1,7,0.14285714285714285,0.8571428571428571
1202,2010,DF,DEPUTADO FEDERAL,PRP,1,1,2,0.5,0.5
1203,2010,DF,DEPUTADO FEDERAL,PTC,3,1,4,0.25,0.75
1204,2010,DF,DEPUTADO FEDERAL,PMDB,5,2,7,0.2857142857142857,0.7142857142857143
1205,2010,DF,DEPUTADO FEDERAL,PSTU,2,1,3,0.3333333333333333,0.6666666666666666
1206,2010,DF,DEPUTADO FEDERAL,PSB,1,1,2,0.5,0.5
1207,2010,DF,DEPUTADO FEDERAL,PP,5,0,5,0.0,1.0
1208,2010,DF,DEPUTADO FEDERAL,PSC,4,2,6,0.3333333333333333,0.6666666666666666
1209,2010,DF,DEPUTADO FEDERAL,PR,2,0,2,0.0,1.0
1210,2010,DF,DEPUTADO FEDERAL,PC do B,1,0,1,0.0,1.0
1211,2010,DF,DEPUTADO FEDERAL,PT do B,1,1,2,0.5,0.5
1212,2010,DF,DEPUTADO FEDERAL,PRB,1,1,2,0.5,0.5
1213,2010,DF,DEPUTADO FEDERAL,PSDB,2,2,4,0.5,0.5
1214,2010,DF,DEPUTADO FEDERAL,PCB,1,0,1,0.0,1.0
1215,2010,DF,DEPUTADO FEDERAL,PCO,0,1,1,1.0,0.0
1216,2010,DF,DEPUTADO FEDERAL,PTN,1,0,1,0.0,1.0
1217,2010,DF,SENADOR,PV,2,0,2,0.0,1.0
1218,2010,DF,SENADOR,PDT,1,0,1,0.0,1.0
1219,2010,DF,SENADOR,PSOL,2,0,2,0.0,1.0
1220,2010,DF,SENADOR,PCO,1,0,1,0.0,1.0
1221,2010,DF,SENADOR,DEM,1,0,1,0.0,1.0
1222,2010,DF,SENADOR,PSDB,0,1,1,1.0,0.0
1223,2010,DF,SENADOR,PTN,1,0,1,0.0,1.0
1224,2010,DF,SENADOR,PSTU,1,0,1,0.0,1.0
1225,2010,DF,SENADOR,PSB,1,0,1,0.0,1.0
1226,2010,DF,SENADOR,PCB,0,1,1,1.0,0.0
1227,2010,DF,SENADOR,PSL,1,0,1,0.0,1.0
1228,2014,DF,DEPUTADO DISTRITAL,PHS,30,21,51,0.4117647058823529,0.5882352941176471
1229,2014,DF,DEPUTADO DISTRITAL,PMDB,33,15,48,0.3125,0.6875
1230,2014,DF,DEPUTADO DISTRITAL,PCB,0,1,1,1.0,0.0
1231,2014,DF,DEPUTADO DISTRITAL,PRTB,38,17,55,0.3090909090909091,0.6909090909090909
1232,2014,DF,DEPUTADO DISTRITAL,PTN,6,2,8,0.25,0.75
1233,2014,DF,DEPUTADO DISTRITAL,PTB,22,4,26,0.15384615384615385,0.8461538461538461
1234,2014,DF,DEPUTADO DISTRITAL,PPL,32,12,44,0.2727272727272727,0.7272727272727273
1235,2014,DF,DEPUTADO DISTRITAL,PV,25,12,37,0.32432432432432434,0.6756756756756757
1236,2014,DF,DEPUTADO DISTRITAL,PEN,33,14,47,0.2978723404255319,0.7021276595744681
1237,2014,DF,DEPUTADO DISTRITAL,PSB,24,11,35,0.3142857142857143,0.6857142857142857
1238,2014,DF,DEPUTADO DISTRITAL,PMN,13,6,19,0.3157894736842105,0.6842105263157895
1239,2014,DF,DEPUTADO DISTRITAL,PSD,33,16,49,0.32653061224489793,0.673469387755102
1240,2014,DF,DEPUTADO DISTRITAL,PSOL,26,12,38,0.3157894736842105,0.6842105263157895
1241,2014,DF,DEPUTADO DISTRITAL,PRP,21,8,29,0.27586206896551724,0.7241379310344828
1242,2014,DF,DEPUTADO DISTRITAL,PC do B,13,9,22,0.4090909090909091,0.5909090909090909
1243,2014,DF,DEPUTADO DISTRITAL,PDT,27,10,37,0.2702702702702703,0.7297297297297297
1244,2014,DF,DEPUTADO DISTRITAL,PT do B,22,3,25,0.12,0.88
1245,2014,DF,DEPUTADO DISTRITAL,PRB,26,11,37,0.2972972972972973,0.7027027027027027
1246,2014,DF,DEPUTADO DISTRITAL,PTC,26,11,37,0.2972972972972973,0.7027027027027027
1247,2014,DF,DEPUTADO DISTRITAL,PROS,23,8,31,0.25806451612903225,0.7419354838709677
1248,2014,DF,DEPUTADO DISTRITAL,PT,29,11,40,0.275,0.725
1249,2014,DF,DEPUTADO DISTRITAL,PSL,18,8,26,0.3076923076923077,0.6923076923076923
1250,2014,DF,DEPUTADO DISTRITAL,PR,28,18,46,0.391304347826087,0.6086956521739131
1251,2014,DF,DEPUTADO DISTRITAL,PPS,34,14,48,0.2916666666666667,0.7083333333333334
1252,2014,DF,DEPUTADO DISTRITAL,DEM,35,15,50,0.3,0.7
1253,2014,DF,DEPUTADO DISTRITAL,PSDC,18,6,24,0.25,0.75
1254,2014,DF,DEPUTADO DISTRITAL,PSDB,32,16,48,0.3333333333333333,0.6666666666666666
1255,2014,DF,DEPUTADO DISTRITAL,PSC,25,15,40,0.375,0.625
1256,2014,DF,DEPUTADO DISTRITAL,PP,15,9,24,0.375,0.625
1257,2014,DF,DEPUTADO DISTRITAL,SD,1,1,2,0.5,0.5
1258,2014,DF,DEPUTADO DISTRITAL,PSTU,1,0,1,0.0,1.0
1259,2014,DF,DEPUTADO DISTRITAL,PCO,1,0,1,0.0,1.0
1260,2014,DF,DEPUTADO FEDERAL,PSOL,9,4,13,0.3076923076923077,0.6923076923076923
1261,2014,DF,DEPUTADO FEDERAL,PT,6,5,11,0.45454545454545453,0.5454545454545454
1262,2014,DF,DEPUTADO FEDERAL,PP,2,1,3,0.3333333333333333,0.6666666666666666
1263,2014,DF,DEPUTADO FEDERAL,PSB,7,3,10,0.3,0.7
1264,2014,DF,DEPUTADO FEDERAL,PPS,2,2,4,0.5,0.5
1265,2014,DF,DEPUTADO FEDERAL,PMDB,4,2,6,0.3333333333333333,0.6666666666666666
1266,2014,DF,DEPUTADO FEDERAL,PSC,2,1,3,0.3333333333333333,0.6666666666666666
1267,2014,DF,DEPUTADO FEDERAL,PDT,8,3,11,0.2727272727272727,0.7272727272727273
1268,2014,DF,DEPUTADO FEDERAL,PMN,1,2,3,0.6666666666666666,0.3333333333333333
1269,2014,DF,DEPUTADO FEDERAL,PTB,3,2,5,0.4,0.6
1270,2014,DF,DEPUTADO FEDERAL,PRTB,4,3,7,0.42857142857142855,0.5714285714285714
1271,2014,DF,DEPUTADO FEDERAL,PPL,2,0,2,0.0,1.0
1272,2014,DF,DEPUTADO FEDERAL,PTC,2,2,4,0.5,0.5
1273,2014,DF,DEPUTADO FEDERAL,PSDB,10,5,15,0.3333333333333333,0.6666666666666666
1274,2014,DF,DEPUTADO FEDERAL,PSDC,4,2,6,0.3333333333333333,0.6666666666666666
1275,2014,DF,DEPUTADO FEDERAL,PHS,2,3,5,0.6,0.4
1276,2014,DF,DEPUTADO FEDERAL,PCB,1,0,1,0.0,1.0
1277,2014,DF,DEPUTADO FEDERAL,PR,5,1,6,0.16666666666666666,0.8333333333333334
1278,2014,DF,DEPUTADO FEDERAL,PRP,1,0,1,0.0,1.0
1279,2014,DF,DEPUTADO FEDERAL,PSD,1,0,1,0.0,1.0
1280,2014,DF,DEPUTADO FEDERAL,SD,1,1,2,0.5,0.5
1281,2014,DF,DEPUTADO FEDERAL,PROS,1,0,1,0.0,1.0
1282,2014,DF,DEPUTADO FEDERAL,PTN,1,1,2,0.5,0.5
1283,2014,DF,DEPUTADO FEDERAL,PSL,1,0,1,0.0,1.0
1284,2014,DF,DEPUTADO FEDERAL,PT do B,2,0,2,0.0,1.0
1285,2014,DF,DEPUTADO FEDERAL,PRB,2,0,2,0.0,1.0
1286,2014,DF,DEPUTADO FEDERAL,DEM,1,0,1,0.0,1.0
1287,2014,DF,DEPUTADO FEDERAL,PEN,1,0,1,0.0,1.0
1288,2014,DF,DEPUTADO FEDERAL,PC do B,1,0,1,0.0,1.0
1289,2014,DF,DEPUTADO FEDERAL,PSTU,1,1,2,0.5,0.5
1290,2014,DF,DEPUTADO FEDERAL,PV,1,0,1,0.0,1.0
1291,2014,DF,DEPUTADO FEDERAL,PCO,1,0,1,0.0,1.0
1292,2014,DF,SENADOR,PDT,1,0,1,0.0,1.0
1293,2014,DF,SENADOR,PT,1,0,1,0.0,1.0
1294,2014,DF,SENADOR,PSTU,1,0,1,0.0,1.0
1295,2014,DF,SENADOR,PSOL,1,0,1,0.0,1.0
1296,2014,DF,SENADOR,PCB,1,0,1,0.0,1.0
1297,2014,DF,SENADOR,PCO,1,0,1,0.0,1.0
1298,2014,DF,SENADOR,PSDB,0,1,1,1.0,0.0
1299,2014,DF,SENADOR,PTB,1,0,1,0.0,1.0
1300,2018,DF,DEPUTADO DISTRITAL,PC do B,10,5,15,0.3333333333333333,0.6666666666666666
1301,2018,DF,DEPUTADO DISTRITAL,PMB,12,12,24,0.5,0.5
1302,2018,DF,DEPUTADO DISTRITAL,PP,34,15,49,0.30612244897959184,0.6938775510204082
1303,2018,DF,DEPUTADO DISTRITAL,PDT,21,8,29,0.27586206896551724,0.7241379310344828
1304,2018,DF,DEPUTADO DISTRITAL,DC,7,2,9,0.2222222222222222,0.7777777777777778
1305,2018,DF,DEPUTADO DISTRITAL,PR,33,15,48,0.3125,0.6875
1306,2018,DF,DEPUTADO DISTRITAL,PT,23,11,34,0.3235294117647059,0.6764705882352942
1307,2018,DF,DEPUTADO DISTRITAL,PATRI,21,4,25,0.16,0.84
1308,2018,DF,DEPUTADO DISTRITAL,PPS,21,9,30,0.3,0.7
1309,2018,DF,DEPUTADO DISTRITAL,PRTB,4,5,9,0.5555555555555556,0.4444444444444444
1310,2018,DF,DEPUTADO DISTRITAL,PODE,16,8,24,0.3333333333333333,0.6666666666666666
1311,2018,DF,DEPUTADO DISTRITAL,PSL,14,9,23,0.391304347826087,0.6086956521739131
1312,2018,DF,DEPUTADO DISTRITAL,REDE,23,10,33,0.30303030303030304,0.696969696969697
1313,2018,DF,DEPUTADO DISTRITAL,MDB,32,16,48,0.3333333333333333,0.6666666666666666
1314,2018,DF,DEPUTADO DISTRITAL,NOVO,21,10,31,0.3225806451612903,0.6774193548387096
1315,2018,DF,DEPUTADO DISTRITAL,PMN,10,8,18,0.4444444444444444,0.5555555555555556
1316,2018,DF,DEPUTADO DISTRITAL,AVANTE,35,16,51,0.3137254901960784,0.6862745098039216
1317,2018,DF,DEPUTADO DISTRITAL,PHS,30,13,43,0.3023255813953488,0.6976744186046512
1318,2018,DF,DEPUTADO DISTRITAL,PTB,33,15,48,0.3125,0.6875
1319,2018,DF,DEPUTADO DISTRITAL,DEM,10,4,14,0.2857142857142857,0.7142857142857143
1320,2018,DF,DEPUTADO DISTRITAL,SOLIDARIEDADE,12,4,16,0.25,0.75
1321,2018,DF,DEPUTADO DISTRITAL,PRB,21,11,32,0.34375,0.65625
1322,2018,DF,DEPUTADO DISTRITAL,PROS,33,15,48,0.3125,0.6875
1323,2018,DF,DEPUTADO DISTRITAL,PV,11,8,19,0.42105263157894735,0.5789473684210527
1324,2018,DF,DEPUTADO DISTRITAL,PSB,24,13,37,0.35135135135135137,0.6486486486486487
1325,2018,DF,DEPUTADO DISTRITAL,PSOL,16,7,23,0.30434782608695654,0.6956521739130435
1326,2018,DF,DEPUTADO DISTRITAL,PSC,34,14,48,0.2916666666666667,0.7083333333333334
1327,2018,DF,DEPUTADO DISTRITAL,PSD,14,5,19,0.2631578947368421,0.7368421052631579
1328,2018,DF,DEPUTADO DISTRITAL,PTC,23,8,31,0.25806451612903225,0.7419354838709677
1329,2018,DF,DEPUTADO DISTRITAL,PSDB,17,9,26,0.34615384615384615,0.6538461538461539
1330,2018,DF,DEPUTADO DISTRITAL,PRP,29,10,39,0.2564102564102564,0.7435897435897436
1331,2018,DF,DEPUTADO DISTRITAL,PPL,19,5,24,0.20833333333333334,0.7916666666666666
1332,2018,DF,DEPUTADO DISTRITAL,PCO,3,2,5,0.4,0.6
1333,2018,DF,DEPUTADO DISTRITAL,PSTU,1,0,1,0.0,1.0
1334,2018,DF,DEPUTADO FEDERAL,PSTU,0,1,1,1.0,0.0
1335,2018,DF,DEPUTADO FEDERAL,PPL,9,4,13,0.3076923076923077,0.6923076923076923
1336,2018,DF,DEPUTADO FEDERAL,NOVO,4,2,6,0.3333333333333333,0.6666666666666666
1337,2018,DF,DEPUTADO FEDERAL,PROS,5,4,9,0.4444444444444444,0.5555555555555556
1338,2018,DF,DEPUTADO FEDERAL,PC do B,2,1,3,0.3333333333333333,0.6666666666666666
1339,2018,DF,DEPUTADO FEDERAL,DC,11,5,16,0.3125,0.6875
1340,2018,DF,DEPUTADO FEDERAL,PSDB,8,2,10,0.2,0.8
1341,2018,DF,DEPUTADO FEDERAL,PSOL,10,5,15,0.3333333333333333,0.6666666666666666
1342,2018,DF,DEPUTADO FEDERAL,PHS,2,1,3,0.3333333333333333,0.6666666666666666
1343,2018,DF,DEPUTADO FEDERAL,PRB,2,2,4,0.5,0.5
1344,2018,DF,DEPUTADO FEDERAL,PTB,5,1,6,0.16666666666666666,0.8333333333333334
1345,2018,DF,DEPUTADO FEDERAL,PDT,4,0,4,0.0,1.0
1346,2018,DF,DEPUTADO FEDERAL,PMN,5,1,6,0.16666666666666666,0.8333333333333334
1347,2018,DF,DEPUTADO FEDERAL,REDE,4,2,6,0.3333333333333333,0.6666666666666666
1348,2018,DF,DEPUTADO FEDERAL,PV,1,1,2,0.5,0.5
1349,2018,DF,DEPUTADO FEDERAL,AVANTE,5,3,8,0.375,0.625
1350,2018,DF,DEPUTADO FEDERAL,PT,10,6,16,0.375,0.625
1351,2018,DF,DEPUTADO FEDERAL,PSB,1,1,2,0.5,0.5
1352,2018,DF,DEPUTADO FEDERAL,PATRI,1,0,1,0.0,1.0
1353,2018,DF,DEPUTADO FEDERAL,PCO,3,1,4,0.25,0.75
1354,2018,DF,DEPUTADO FEDERAL,PTC,3,3,6,0.5,0.5
1355,2018,DF,DEPUTADO FEDERAL,DEM,2,1,3,0.3333333333333333,0.6666666666666666
1356,2018,DF,DEPUTADO FEDERAL,PRTB,4,2,6,0.3333333333333333,0.6666666666666666
1357,2018,DF,DEPUTADO FEDERAL,PSC,3,2,5,0.4,0.6
1358,2018,DF,DEPUTADO FEDERAL,PPS,3,1,4,0.25,0.75
1359,2018,DF,DEPUTADO FEDERAL,PR,3,2,5,0.4,0.6
1360,2018,DF,DEPUTADO FEDERAL,PSL,3,0,3,0.0,1.0
1361,2018,DF,DEPUTADO FEDERAL,PP,1,1,2,0.5,0.5
1362,2018,DF,DEPUTADO FEDERAL,PRP,7,3,10,0.3,0.7
1363,2018,DF,DEPUTADO FEDERAL,PMB,2,0,2,0.0,1.0
1364,2018,DF,DEPUTADO FEDERAL,MDB,2,1,3,0.3333333333333333,0.6666666666666666
1365,2018,DF,DEPUTADO FEDERAL,PCB,1,0,1,0.0,1.0
1366,2018,DF,DEPUTADO FEDERAL,SOLIDARIEDADE,1,0,1,0.0,1.0
1367,2018,DF,DEPUTADO FEDERAL,PSD,1,0,1,0.0,1.0
1368,2018,DF,DEPUTADO FEDERAL,PODE,1,0,1,0.0,1.0
1369,2018,DF,SENADOR,PSDB,1,1,2,0.5,0.5
1370,2018,DF,SENADOR,PT,2,0,2,0.0,1.0
1371,2018,DF,SENADOR,PPL,1,0,1,0.0,1.0
1372,2018,DF,SENADOR,PSOL,2,0,2,0.0,1.0
1373,2018,DF,SENADOR,REDE,1,0,1,0.0,1.0
1374,2018,DF,SENADOR,PP,1,0,1,0.0,1.0
1375,2018,DF,SENADOR,PPS,1,0,1,0.0,1.0
1376,2018,DF,SENADOR,PSTU,1,0,1,0.0,1.0
1377,2018,DF,SENADOR,NOVO,1,0,1,0.0,1.0
1378,2018,DF,SENADOR,PTB,1,0,1,0.0,1.0
1379,2018,DF,SENADOR,PSB,0,1,1,1.0,0.0
1380,2018,DF,SENADOR,PR,0,1,1,1.0,0.0
1381,2018,DF,SENADOR,PRP,1,0,1,0.0,1.0
1382,2018,DF,SENADOR,PMN,1,0,1,0.0,1.0
1383,2018,DF,SENADOR,SOLIDARIEDADE,1,0,1,0.0,1.0
1384,2018,DF,SENADOR,PRTB,1,0,1,0.0,1.0
1385,2018,DF,SENADOR,PCO,1,0,1,0.0,1.0
1386,2010,ES,DEPUTADO ESTADUAL,PRP,23,3,26,0.11538461538461539,0.8846153846153846
1387,2010,ES,DEPUTADO ESTADUAL,PC do B,7,1,8,0.125,0.875
1388,2010,ES,DEPUTADO ESTADUAL,PPS,8,2,10,0.2,0.8
1389,2010,ES,DEPUTADO ESTADUAL,PSC,16,2,18,0.1111111111111111,0.8888888888888888
1390,2010,ES,DEPUTADO ESTADUAL,PTB,31,4,35,0.11428571428571428,0.8857142857142857
1391,2010,ES,DEPUTADO ESTADUAL,PHS,15,1,16,0.0625,0.9375
1392,2010,ES,DEPUTADO ESTADUAL,PSL,16,2,18,0.1111111111111111,0.8888888888888888
1393,2010,ES,DEPUTADO ESTADUAL,PSDC,16,1,17,0.058823529411764705,0.9411764705882353
1394,2010,ES,DEPUTADO ESTADUAL,PSDB,20,2,22,0.09090909090909091,0.9090909090909091
1395,2010,ES,DEPUTADO ESTADUAL,PP,25,1,26,0.038461538461538464,0.9615384615384616
1396,2010,ES,DEPUTADO ESTADUAL,PTC,13,3,16,0.1875,0.8125
1397,2010,ES,DEPUTADO ESTADUAL,PSOL,8,0,8,0.0,1.0
1398,2010,ES,DEPUTADO ESTADUAL,PTN,14,2,16,0.125,0.875
1399,2010,ES,DEPUTADO ESTADUAL,PR,13,0,13,0.0,1.0
1400,2010,ES,DEPUTADO ESTADUAL,PSB,28,3,31,0.0967741935483871,0.9032258064516129
1401,2010,ES,DEPUTADO ESTADUAL,PMDB,16,6,22,0.2727272727272727,0.7272727272727273
1402,2010,ES,DEPUTADO ESTADUAL,PDT,26,2,28,0.07142857142857142,0.9285714285714286
1403,2010,ES,DEPUTADO ESTADUAL,PT,18,3,21,0.14285714285714285,0.8571428571428571
1404,2010,ES,DEPUTADO ESTADUAL,DEM,10,0,10,0.0,1.0
1405,2010,ES,DEPUTADO ESTADUAL,PV,23,1,24,0.041666666666666664,0.9583333333333334
1406,2010,ES,DEPUTADO ESTADUAL,PRTB,5,2,7,0.2857142857142857,0.7142857142857143
1407,2010,ES,DEPUTADO ESTADUAL,PT do B,12,3,15,0.2,0.8
1408,2010,ES,DEPUTADO ESTADUAL,PRB,5,1,6,0.16666666666666666,0.8333333333333334
1409,2010,ES,DEPUTADO ESTADUAL,PMN,5,1,6,0.16666666666666666,0.8333333333333334
1410,2010,ES,DEPUTADO FEDERAL,PV,3,2,5,0.4,0.6
1411,2010,ES,DEPUTADO FEDERAL,PRB,2,0,2,0.0,1.0
1412,2010,ES,DEPUTADO FEDERAL,PSL,2,0,2,0.0,1.0
1413,2010,ES,DEPUTADO FEDERAL,PSDB,3,0,3,0.0,1.0
1414,2010,ES,DEPUTADO FEDERAL,PPS,4,1,5,0.2,0.8
1415,2010,ES,DEPUTADO FEDERAL,PMDB,3,1,4,0.25,0.75
1416,2010,ES,DEPUTADO FEDERAL,PDT,6,2,8,0.25,0.75
1417,2010,ES,DEPUTADO FEDERAL,DEM,4,0,4,0.0,1.0
1418,2010,ES,DEPUTADO FEDERAL,PSB,8,2,10,0.2,0.8
1419,2010,ES,DEPUTADO FEDERAL,PR,4,1,5,0.2,0.8
1420,2010,ES,DEPUTADO FEDERAL,PMN,5,0,5,0.0,1.0
1421,2010,ES,DEPUTADO FEDERAL,PT do B,0,2,2,1.0,0.0
1422,2010,ES,DEPUTADO FEDERAL,PT,5,2,7,0.2857142857142857,0.7142857142857143
1423,2010,ES,DEPUTADO FEDERAL,PTB,8,1,9,0.1111111111111111,0.8888888888888888
1424,2010,ES,DEPUTADO FEDERAL,PP,2,0,2,0.0,1.0
1425,2010,ES,DEPUTADO FEDERAL,PC do B,2,0,2,0.0,1.0
1426,2010,ES,DEPUTADO FEDERAL,PSOL,5,0,5,0.0,1.0
1427,2010,ES,DEPUTADO FEDERAL,PCO,1,0,1,0.0,1.0
1428,2010,ES,DEPUTADO FEDERAL,PTC,3,0,3,0.0,1.0
1429,2010,ES,DEPUTADO FEDERAL,PSC,2,1,3,0.3333333333333333,0.6666666666666666
1430,2010,ES,DEPUTADO FEDERAL,PHS,2,0,2,0.0,1.0
1431,2010,ES,DEPUTADO FEDERAL,PRTB,1,0,1,0.0,1.0
1432,2010,ES,SENADOR,PSL,1,0,1,0.0,1.0
1433,2010,ES,SENADOR,PR,1,0,1,0.0,1.0
1434,2010,ES,SENADOR,PSOL,1,0,1,0.0,1.0
1435,2010,ES,SENADOR,PMDB,1,0,1,0.0,1.0
1436,2010,ES,SENADOR,PSDB,0,1,1,1.0,0.0
1437,2014,ES,DEPUTADO ESTADUAL,PT,11,6,17,0.35294117647058826,0.6470588235294118
1438,2014,ES,DEPUTADO ESTADUAL,PV,14,5,19,0.2631578947368421,0.7368421052631579
1439,2014,ES,DEPUTADO ESTADUAL,PSC,15,7,22,0.3181818181818182,0.6818181818181818
1440,2014,ES,DEPUTADO ESTADUAL,PTN,7,3,10,0.3,0.7
1441,2014,ES,DEPUTADO ESTADUAL,PTB,10,5,15,0.3333333333333333,0.6666666666666666
1442,2014,ES,DEPUTADO ESTADUAL,PP,20,10,30,0.3333333333333333,0.6666666666666666
1443,2014,ES,DEPUTADO ESTADUAL,PSL,8,6,14,0.42857142857142855,0.5714285714285714
1444,2014,ES,DEPUTADO ESTADUAL,PT do B,18,5,23,0.21739130434782608,0.782608695652174
1445,2014,ES,DEPUTADO ESTADUAL,PRB,13,4,17,0.23529411764705882,0.7647058823529411
1446,2014,ES,DEPUTADO ESTADUAL,PRTB,6,2,8,0.25,0.75
1447,2014,ES,DEPUTADO ESTADUAL,PRP,51,30,81,0.37037037037037035,0.6296296296296297
1448,2014,ES,DEPUTADO ESTADUAL,DEM,14,5,19,0.2631578947368421,0.7368421052631579
1449,2014,ES,DEPUTADO ESTADUAL,PHS,17,6,23,0.2608695652173913,0.7391304347826086
1450,2014,ES,DEPUTADO ESTADUAL,PC do B,17,7,24,0.2916666666666667,0.7083333333333334
1451,2014,ES,DEPUTADO ESTADUAL,PPS,11,2,13,0.15384615384615385,0.8461538461538461
1452,2014,ES,DEPUTADO ESTADUAL,PSDB,37,18,55,0.32727272727272727,0.6727272727272727
1453,2014,ES,DEPUTADO ESTADUAL,PSB,21,16,37,0.43243243243243246,0.5675675675675675
1454,2014,ES,DEPUTADO ESTADUAL,PSOL,7,3,10,0.3,0.7
1455,2014,ES,DEPUTADO ESTADUAL,SD,14,4,18,0.2222222222222222,0.7777777777777778
1456,2014,ES,DEPUTADO ESTADUAL,PPL,5,4,9,0.4444444444444444,0.5555555555555556
1457,2014,ES,DEPUTADO ESTADUAL,PR,11,5,16,0.3125,0.6875
1458,2014,ES,DEPUTADO ESTADUAL,PDT,13,5,18,0.2777777777777778,0.7222222222222222
1459,2014,ES,DEPUTADO ESTADUAL,PSDC,10,3,13,0.23076923076923078,0.7692307692307693
1460,2014,ES,DEPUTADO ESTADUAL,PTC,3,5,8,0.625,0.375
1461,2014,ES,DEPUTADO ESTADUAL,PMDB,16,8,24,0.3333333333333333,0.6666666666666666
1462,2014,ES,DEPUTADO ESTADUAL,PEN,9,4,13,0.3076923076923077,0.6923076923076923
1463,2014,ES,DEPUTADO ESTADUAL,PSD,6,1,7,0.14285714285714285,0.8571428571428571
1464,2014,ES,DEPUTADO ESTADUAL,PROS,5,0,5,0.0,1.0
1465,2014,ES,DEPUTADO ESTADUAL,PSTU,1,1,2,0.5,0.5
1466,2014,ES,DEPUTADO ESTADUAL,PMN,0,1,1,1.0,0.0
1467,2014,ES,DEPUTADO FEDERAL,PEN,5,0,5,0.0,1.0
1468,2014,ES,DEPUTADO FEDERAL,PR,7,4,11,0.36363636363636365,0.6363636363636364
1469,2014,ES,DEPUTADO FEDERAL,PSDC,3,1,4,0.25,0.75
1470,2014,ES,DEPUTADO FEDERAL,DEM,10,4,14,0.2857142857142857,0.7142857142857143
1471,2014,ES,DEPUTADO FEDERAL,PMDB,3,2,5,0.4,0.6
1472,2014,ES,DEPUTADO FEDERAL,PP,4,2,6,0.3333333333333333,0.6666666666666666
1473,2014,ES,DEPUTADO FEDERAL,PHS,1,1,2,0.5,0.5
1474,2014,ES,DEPUTADO FEDERAL,PDT,11,3,14,0.21428571428571427,0.7857142857142857
1475,2014,ES,DEPUTADO FEDERAL,PSOL,4,2,6,0.3333333333333333,0.6666666666666666
1476,2014,ES,DEPUTADO FEDERAL,PRP,16,9,25,0.36,0.64
1477,2014,ES,DEPUTADO FEDERAL,PSB,14,5,19,0.2631578947368421,0.7368421052631579
1478,2014,ES,DEPUTADO FEDERAL,PRTB,5,1,6,0.16666666666666666,0.8333333333333334
1479,2014,ES,DEPUTADO FEDERAL,PT,5,5,10,0.5,0.5
1480,2014,ES,DEPUTADO FEDERAL,PSDB,6,3,9,0.3333333333333333,0.6666666666666666
1481,2014,ES,DEPUTADO FEDERAL,PROS,1,0,1,0.0,1.0
1482,2014,ES,DEPUTADO FEDERAL,PC do B,1,1,2,0.5,0.5
1483,2014,ES,DEPUTADO FEDERAL,PSL,3,3,6,0.5,0.5
1484,2014,ES,DEPUTADO FEDERAL,PV,5,3,8,0.375,0.625
1485,2014,ES,DEPUTADO FEDERAL,PSD,2,1,3,0.3333333333333333,0.6666666666666666
1486,2014,ES,DEPUTADO FEDERAL,PMN,1,1,2,0.5,0.5
1487,2014,ES,DEPUTADO FEDERAL,PTC,3,0,3,0.0,1.0
1488,2014,ES,DEPUTADO FEDERAL,PRB,4,2,6,0.3333333333333333,0.6666666666666666
1489,2014,ES,DEPUTADO FEDERAL,PPS,2,1,3,0.3333333333333333,0.6666666666666666
1490,2014,ES,DEPUTADO FEDERAL,PCB,1,1,2,0.5,0.5
1491,2014,ES,DEPUTADO FEDERAL,SD,3,1,4,0.25,0.75
1492,2014,ES,DEPUTADO FEDERAL,PT do B,4,0,4,0.0,1.0
1493,2014,ES,DEPUTADO FEDERAL,PSC,2,1,3,0.3333333333333333,0.6666666666666666
1494,2014,ES,DEPUTADO FEDERAL,PTB,3,1,4,0.25,0.75
1495,2014,ES,DEPUTADO FEDERAL,PTN,0,1,1,1.0,0.0
1496,2014,ES,DEPUTADO FEDERAL,PPL,0,1,1,1.0,0.0
1497,2014,ES,DEPUTADO FEDERAL,PCO,1,0,1,0.0,1.0
1498,2014,ES,SENADOR,PT,1,0,1,0.0,1.0
1499,2014,ES,SENADOR,PV,1,0,1,0.0,1.0
1500,2014,ES,SENADOR,PMDB,0,1,1,1.0,0.0
1501,2014,ES,SENADOR,PSOL,1,0,1,0.0,1.0
1502,2014,ES,SENADOR,PSTU,1,0,1,0.0,1.0
1503,2014,ES,SENADOR,PR,1,0,1,0.0,1.0
1504,2018,ES,DEPUTADO ESTADUAL,PSB,28,13,41,0.3170731707317073,0.6829268292682927
1505,2018,ES,DEPUTADO ESTADUAL,PSOL,5,5,10,0.5,0.5
1506,2018,ES,DEPUTADO ESTADUAL,AVANTE,14,6,20,0.3,0.7
1507,2018,ES,DEPUTADO ESTADUAL,PR,11,2,13,0.15384615384615385,0.8461538461538461
1508,2018,ES,DEPUTADO ESTADUAL,PPL,9,3,12,0.25,0.75
1509,2018,ES,DEPUTADO ESTADUAL,PRP,21,8,29,0.27586206896551724,0.7241379310344828
1510,2018,ES,DEPUTADO ESTADUAL,PSC,20,5,25,0.2,0.8
1511,2018,ES,DEPUTADO ESTADUAL,SOLIDARIEDADE,9,5,14,0.35714285714285715,0.6428571428571429
1512,2018,ES,DEPUTADO ESTADUAL,PV,18,8,26,0.3076923076923077,0.6923076923076923
1513,2018,ES,DEPUTADO ESTADUAL,PDT,6,4,10,0.4,0.6
1514,2018,ES,DEPUTADO ESTADUAL,PATRI,4,2,6,0.3333333333333333,0.6666666666666666
1515,2018,ES,DEPUTADO ESTADUAL,PMB,10,10,20,0.5,0.5
1516,2018,ES,DEPUTADO ESTADUAL,PP,21,11,32,0.34375,0.65625
1517,2018,ES,DEPUTADO ESTADUAL,PSDB,19,13,32,0.40625,0.59375
1518,2018,ES,DEPUTADO ESTADUAL,PC do B,21,10,31,0.3225806451612903,0.6774193548387096
1519,2018,ES,DEPUTADO ESTADUAL,PMN,7,6,13,0.46153846153846156,0.5384615384615384
1520,2018,ES,DEPUTADO ESTADUAL,PROS,20,7,27,0.25925925925925924,0.7407407407407407
1521,2018,ES,DEPUTADO ESTADUAL,PTC,13,4,17,0.23529411764705882,0.7647058823529411
1522,2018,ES,DEPUTADO ESTADUAL,PPS,16,8,24,0.3333333333333333,0.6666666666666666
1523,2018,ES,DEPUTADO ESTADUAL,PSL,13,6,19,0.3157894736842105,0.6842105263157895
1524,2018,ES,DEPUTADO ESTADUAL,PRB,19,10,29,0.3448275862068966,0.6551724137931034
1525,2018,ES,DEPUTADO ESTADUAL,PTB,24,6,30,0.2,0.8
1526,2018,ES,DEPUTADO ESTADUAL,DC,11,4,15,0.26666666666666666,0.7333333333333333
1527,2018,ES,DEPUTADO ESTADUAL,PHS,11,5,16,0.3125,0.6875
1528,2018,ES,DEPUTADO ESTADUAL,PT,12,6,18,0.3333333333333333,0.6666666666666666
1529,2018,ES,DEPUTADO ESTADUAL,PODE,10,6,16,0.375,0.625
1530,2018,ES,DEPUTADO ESTADUAL,MDB,12,6,18,0.3333333333333333,0.6666666666666666
1531,2018,ES,DEPUTADO ESTADUAL,REDE,15,4,19,0.21052631578947367,0.7894736842105263
1532,2018,ES,DEPUTADO ESTADUAL,PSD,9,4,13,0.3076923076923077,0.6923076923076923
1533,2018,ES,DEPUTADO ESTADUAL,DEM,6,4,10,0.4,0.6
1534,2018,ES,DEPUTADO ESTADUAL,PRTB,6,0,6,0.0,1.0
1535,2018,ES,DEPUTADO FEDERAL,PT,9,7,16,0.4375,0.5625
1536,2018,ES,DEPUTADO FEDERAL,PRTB,4,3,7,0.42857142857142855,0.5714285714285714
1537,2018,ES,DEPUTADO FEDERAL,PTB,10,3,13,0.23076923076923078,0.7692307692307693
1538,2018,ES,DEPUTADO FEDERAL,PSDB,2,1,3,0.3333333333333333,0.6666666666666666
1539,2018,ES,DEPUTADO FEDERAL,PSB,6,4,10,0.4,0.6
1540,2018,ES,DEPUTADO FEDERAL,AVANTE,2,0,2,0.0,1.0
1541,2018,ES,DEPUTADO FEDERAL,PSOL,4,3,7,0.42857142857142855,0.5714285714285714
1542,2018,ES,DEPUTADO FEDERAL,REDE,5,2,7,0.2857142857142857,0.7142857142857143
1543,2018,ES,DEPUTADO FEDERAL,PRB,6,4,10,0.4,0.6
1544,2018,ES,DEPUTADO FEDERAL,PMB,4,3,7,0.42857142857142855,0.5714285714285714
1545,2018,ES,DEPUTADO FEDERAL,PSL,6,2,8,0.25,0.75
1546,2018,ES,DEPUTADO FEDERAL,DC,8,4,12,0.3333333333333333,0.6666666666666666
1547,2018,ES,DEPUTADO FEDERAL,PODE,4,3,7,0.42857142857142855,0.5714285714285714
1548,2018,ES,DEPUTADO FEDERAL,NOVO,4,2,6,0.3333333333333333,0.6666666666666666
1549,2018,ES,DEPUTADO FEDERAL,MDB,3,1,4,0.25,0.75
1550,2018,ES,DEPUTADO FEDERAL,PRP,3,1,4,0.25,0.75
1551,2018,ES,DEPUTADO FEDERAL,PSD,1,2,3,0.6666666666666666,0.3333333333333333
1552,2018,ES,DEPUTADO FEDERAL,PV,3,2,5,0.4,0.6
1553,2018,ES,DEPUTADO FEDERAL,PR,2,1,3,0.3333333333333333,0.6666666666666666
1554,2018,ES,DEPUTADO FEDERAL,PDT,5,1,6,0.16666666666666666,0.8333333333333334
1555,2018,ES,DEPUTADO FEDERAL,PROS,2,1,3,0.3333333333333333,0.6666666666666666
1556,2018,ES,DEPUTADO FEDERAL,PP,4,3,7,0.42857142857142855,0.5714285714285714
1557,2018,ES,DEPUTADO FEDERAL,DEM,1,1,2,0.5,0.5
1558,2018,ES,DEPUTADO FEDERAL,PTC,1,0,1,0.0,1.0
1559,2018,ES,DEPUTADO FEDERAL,SOLIDARIEDADE,1,1,2,0.5,0.5
1560,2018,ES,DEPUTADO FEDERAL,PC do B,1,0,1,0.0,1.0
1561,2018,ES,DEPUTADO FEDERAL,PPS,4,2,6,0.3333333333333333,0.6666666666666666
1562,2018,ES,DEPUTADO FEDERAL,PHS,3,0,3,0.0,1.0
1563,2018,ES,DEPUTADO FEDERAL,PATRI,1,0,1,0.0,1.0
1564,2018,ES,DEPUTADO FEDERAL,PSC,1,0,1,0.0,1.0
1565,2018,ES,DEPUTADO FEDERAL,PMN,1,0,1,0.0,1.0
1566,2018,ES,DEPUTADO FEDERAL,PPL,1,0,1,0.0,1.0
1567,2018,ES,SENADOR,REDE,1,0,1,0.0,1.0
1568,2018,ES,SENADOR,PSDB,1,0,1,0.0,1.0
1569,2018,ES,SENADOR,PSOL,0,1,1,1.0,0.0
1570,2018,ES,SENADOR,PTB,1,0,1,0.0,1.0
1571,2018,ES,SENADOR,NOVO,1,0,1,0.0,1.0
1572,2018,ES,SENADOR,PR,1,0,1,0.0,1.0
1573,2018,ES,SENADOR,PT,0,1,1,1.0,0.0
1574,2018,ES,SENADOR,PSL,1,0,1,0.0,1.0
1575,2018,ES,SENADOR,PCB,1,0,1,0.0,1.0
1576,2018,ES,SENADOR,PMB,1,0,1,0.0,1.0
1577,2018,ES,SENADOR,PPS,1,0,1,0.0,1.0
1578,2010,GO,DEPUTADO ESTADUAL,PR,17,5,22,0.22727272727272727,0.7727272727272727
1579,2010,GO,DEPUTADO ESTADUAL,PSOL,43,20,63,0.31746031746031744,0.6825396825396826
1580,2010,GO,DEPUTADO ESTADUAL,PRB,35,2,37,0.05405405405405406,0.9459459459459459
1581,2010,GO,DEPUTADO ESTADUAL,PSB,18,5,23,0.21739130434782608,0.782608695652174
1582,2010,GO,DEPUTADO ESTADUAL,PSL,44,9,53,0.16981132075471697,0.8301886792452831
1583,2010,GO,DEPUTADO ESTADUAL,PC do B,30,9,39,0.23076923076923078,0.7692307692307693
1584,2010,GO,DEPUTADO ESTADUAL,PT,37,9,46,0.1956521739130435,0.8043478260869565
1585,2010,GO,DEPUTADO ESTADUAL,PPS,16,1,17,0.058823529411764705,0.9411764705882353
1586,2010,GO,DEPUTADO ESTADUAL,PDT,26,28,54,0.5185185185185185,0.48148148148148145
1587,2010,GO,DEPUTADO ESTADUAL,PRP,20,2,22,0.09090909090909091,0.9090909090909091
1588,2010,GO,DEPUTADO ESTADUAL,PMDB,30,10,40,0.25,0.75
1589,2010,GO,DEPUTADO ESTADUAL,PMN,19,7,26,0.2692307692307692,0.7307692307692307
1590,2010,GO,DEPUTADO ESTADUAL,PHS,13,1,14,0.07142857142857142,0.9285714285714286
1591,2010,GO,DEPUTADO ESTADUAL,PSDB,32,6,38,0.15789473684210525,0.8421052631578947
1592,2010,GO,DEPUTADO ESTADUAL,PP,13,5,18,0.2777777777777778,0.7222222222222222
1593,2010,GO,DEPUTADO ESTADUAL,PV,12,2,14,0.14285714285714285,0.8571428571428571
1594,2010,GO,DEPUTADO ESTADUAL,PRTB,24,1,25,0.04,0.96
1595,2010,GO,DEPUTADO ESTADUAL,PSTU,0,1,1,1.0,0.0
1596,2010,GO,DEPUTADO ESTADUAL,PTB,23,7,30,0.23333333333333334,0.7666666666666667
1597,2010,GO,DEPUTADO ESTADUAL,DEM,9,1,10,0.1,0.9
1598,2010,GO,DEPUTADO ESTADUAL,PSC,21,5,26,0.19230769230769232,0.8076923076923077
1599,2010,GO,DEPUTADO ESTADUAL,PTN,9,2,11,0.18181818181818182,0.8181818181818182
1600,2010,GO,DEPUTADO ESTADUAL,PSDC,5,0,5,0.0,1.0
1601,2010,GO,DEPUTADO ESTADUAL,PT do B,9,0,9,0.0,1.0
1602,2010,GO,DEPUTADO ESTADUAL,PCB,1,0,1,0.0,1.0
1603,2010,GO,DEPUTADO ESTADUAL,PTC,1,0,1,0.0,1.0
1604,2010,GO,DEPUTADO FEDERAL,PTB,7,2,9,0.2222222222222222,0.7777777777777778
1605,2010,GO,DEPUTADO FEDERAL,DEM,7,1,8,0.125,0.875
1606,2010,GO,DEPUTADO FEDERAL,PR,7,0,7,0.0,1.0
1607,2010,GO,DEPUTADO FEDERAL,PT,10,1,11,0.09090909090909091,0.9090909090909091
1608,2010,GO,DEPUTADO FEDERAL,PSL,6,1,7,0.14285714285714285,0.8571428571428571
1609,2010,GO,DEPUTADO FEDERAL,PSOL,3,1,4,0.25,0.75
1610,2010,GO,DEPUTADO FEDERAL,PV,10,0,10,0.0,1.0
1611,2010,GO,DEPUTADO FEDERAL,PSDB,14,1,15,0.06666666666666667,0.9333333333333333
1612,2010,GO,DEPUTADO FEDERAL,PRB,9,1,10,0.1,0.9
1613,2010,GO,DEPUTADO FEDERAL,PMN,1,0,1,0.0,1.0
1614,2010,GO,DEPUTADO FEDERAL,PSC,7,0,7,0.0,1.0
1615,2010,GO,DEPUTADO FEDERAL,PHS,9,0,9,0.0,1.0
1616,2010,GO,DEPUTADO FEDERAL,PTC,12,3,15,0.2,0.8
1617,2010,GO,DEPUTADO FEDERAL,PMDB,17,2,19,0.10526315789473684,0.8947368421052632
1618,2010,GO,DEPUTADO FEDERAL,PDT,0,2,2,1.0,0.0
1619,2010,GO,DEPUTADO FEDERAL,PRP,3,0,3,0.0,1.0
1620,2010,GO,DEPUTADO FEDERAL,PRTB,1,0,1,0.0,1.0
1621,2010,GO,DEPUTADO FEDERAL,PC do B,1,0,1,0.0,1.0
1622,2010,GO,DEPUTADO FEDERAL,PTN,1,0,1,0.0,1.0
1623,2010,GO,DEPUTADO FEDERAL,PPS,2,0,2,0.0,1.0
1624,2010,GO,DEPUTADO FEDERAL,PP,6,0,6,0.0,1.0
1625,2010,GO,DEPUTADO FEDERAL,PCB,1,0,1,0.0,1.0
1626,2010,GO,DEPUTADO FEDERAL,PSB,1,0,1,0.0,1.0
1627,2010,GO,DEPUTADO FEDERAL,PSTU,1,0,1,0.0,1.0
1628,2010,GO,SENADOR,PMDB,1,0,1,0.0,1.0
1629,2010,GO,SENADOR,PCB,1,0,1,0.0,1.0
1630,2010,GO,SENADOR,DEM,1,0,1,0.0,1.0
1631,2010,GO,SENADOR,PSOL,1,0,1,0.0,1.0
1632,2010,GO,SENADOR,PP,3,0,3,0.0,1.0
1633,2010,GO,SENADOR,PSDB,0,1,1,1.0,0.0
1634,2010,GO,SENADOR,PT,1,0,1,0.0,1.0
1635,2010,GO,SENADOR,PSTU,1,0,1,0.0,1.0
1636,2014,GO,DEPUTADO ESTADUAL,PSOL,14,6,20,0.3,0.7
1637,2014,GO,DEPUTADO ESTADUAL,PRB,22,11,33,0.3333333333333333,0.6666666666666666
1638,2014,GO,DEPUTADO ESTADUAL,PRTB,29,22,51,0.43137254901960786,0.5686274509803921
1639,2014,GO,DEPUTADO ESTADUAL,PMN,21,13,34,0.38235294117647056,0.6176470588235294
1640,2014,GO,DEPUTADO ESTADUAL,PSDB,22,10,32,0.3125,0.6875
1641,2014,GO,DEPUTADO ESTADUAL,PHS,38,16,54,0.2962962962962963,0.7037037037037037
1642,2014,GO,DEPUTADO ESTADUAL,PSDC,9,9,18,0.5,0.5
1643,2014,GO,DEPUTADO ESTADUAL,PSL,50,22,72,0.3055555555555556,0.6944444444444444
1644,2014,GO,DEPUTADO ESTADUAL,PT,41,19,60,0.31666666666666665,0.6833333333333333
1645,2014,GO,DEPUTADO ESTADUAL,PTB,14,7,21,0.3333333333333333,0.6666666666666666
1646,2014,GO,DEPUTADO ESTADUAL,SD,18,1,19,0.05263157894736842,0.9473684210526315
1647,2014,GO,DEPUTADO ESTADUAL,PDT,24,7,31,0.22580645161290322,0.7741935483870968
1648,2014,GO,DEPUTADO ESTADUAL,PSB,37,8,45,0.17777777777777778,0.8222222222222222
1649,2014,GO,DEPUTADO ESTADUAL,PRP,7,0,7,0.0,1.0
1650,2014,GO,DEPUTADO ESTADUAL,PSC,21,20,41,0.4878048780487805,0.5121951219512195
1651,2014,GO,DEPUTADO ESTADUAL,PMDB,42,17,59,0.288135593220339,0.711864406779661
1652,2014,GO,DEPUTADO ESTADUAL,DEM,10,5,15,0.3333333333333333,0.6666666666666666
1653,2014,GO,DEPUTADO ESTADUAL,PSD,19,7,26,0.2692307692307692,0.7307692307692307
1654,2014,GO,DEPUTADO ESTADUAL,PP,16,7,23,0.30434782608695654,0.6956521739130435
1655,2014,GO,DEPUTADO ESTADUAL,PTN,11,4,15,0.26666666666666666,0.7333333333333333
1656,2014,GO,DEPUTADO ESTADUAL,PPL,13,4,17,0.23529411764705882,0.7647058823529411
1657,2014,GO,DEPUTADO ESTADUAL,PROS,21,10,31,0.3225806451612903,0.6774193548387096
1658,2014,GO,DEPUTADO ESTADUAL,PT do B,2,1,3,0.3333333333333333,0.6666666666666666
1659,2014,GO,DEPUTADO ESTADUAL,PEN,36,15,51,0.29411764705882354,0.7058823529411765
1660,2014,GO,DEPUTADO ESTADUAL,PPS,9,5,14,0.35714285714285715,0.6428571428571429
1661,2014,GO,DEPUTADO ESTADUAL,PC do B,16,8,24,0.3333333333333333,0.6666666666666666
1662,2014,GO,DEPUTADO ESTADUAL,PV,14,1,15,0.06666666666666667,0.9333333333333333
1663,2014,GO,DEPUTADO ESTADUAL,PTC,3,0,3,0.0,1.0
1664,2014,GO,DEPUTADO ESTADUAL,PR,7,3,10,0.3,0.7
1665,2014,GO,DEPUTADO ESTADUAL,PCB,1,0,1,0.0,1.0
1666,2014,GO,DEPUTADO ESTADUAL,PSTU,0,1,1,1.0,0.0
1667,2014,GO,DEPUTADO FEDERAL,PT,5,3,8,0.375,0.625
1668,2014,GO,DEPUTADO FEDERAL,PSB,5,1,6,0.16666666666666666,0.8333333333333334
1669,2014,GO,DEPUTADO FEDERAL,PRP,6,1,7,0.14285714285714285,0.8571428571428571
1670,2014,GO,DEPUTADO FEDERAL,PSDC,5,4,9,0.4444444444444444,0.5555555555555556
1671,2014,GO,DEPUTADO FEDERAL,PPS,1,0,1,0.0,1.0
1672,2014,GO,DEPUTADO FEDERAL,PMDB,9,5,14,0.35714285714285715,0.6428571428571429
1673,2014,GO,DEPUTADO FEDERAL,PRTB,8,0,8,0.0,1.0
1674,2014,GO,DEPUTADO FEDERAL,PHS,12,7,19,0.3684210526315789,0.631578947368421
1675,2014,GO,DEPUTADO FEDERAL,PSOL,3,2,5,0.4,0.6
1676,2014,GO,DEPUTADO FEDERAL,PSC,5,5,10,0.5,0.5
1677,2014,GO,DEPUTADO FEDERAL,PV,3,1,4,0.25,0.75
1678,2014,GO,DEPUTADO FEDERAL,PSDB,11,7,18,0.3888888888888889,0.6111111111111112
1679,2014,GO,DEPUTADO FEDERAL,DEM,4,2,6,0.3333333333333333,0.6666666666666666
1680,2014,GO,DEPUTADO FEDERAL,PTB,5,1,6,0.16666666666666666,0.8333333333333334
1681,2014,GO,DEPUTADO FEDERAL,PTC,14,4,18,0.2222222222222222,0.7777777777777778
1682,2014,GO,DEPUTADO FEDERAL,PP,3,1,4,0.25,0.75
1683,2014,GO,DEPUTADO FEDERAL,PSL,6,3,9,0.3333333333333333,0.6666666666666666
1684,2014,GO,DEPUTADO FEDERAL,PEN,4,1,5,0.2,0.8
1685,2014,GO,DEPUTADO FEDERAL,PSD,4,1,5,0.2,0.8
1686,2014,GO,DEPUTADO FEDERAL,SD,1,0,1,0.0,1.0
1687,2014,GO,DEPUTADO FEDERAL,PC do B,0,1,1,1.0,0.0
1688,2014,GO,DEPUTADO FEDERAL,PTN,1,0,1,0.0,1.0
1689,2014,GO,DEPUTADO FEDERAL,PSTU,1,0,1,0.0,1.0
1690,2014,GO,DEPUTADO FEDERAL,PPL,0,1,1,1.0,0.0
1691,2014,GO,DEPUTADO FEDERAL,PRB,1,0,1,0.0,1.0
1692,2014,GO,DEPUTADO FEDERAL,PROS,3,1,4,0.25,0.75
1693,2014,GO,DEPUTADO FEDERAL,PR,0,1,1,1.0,0.0
1694,2014,GO,DEPUTADO FEDERAL,PMN,1,0,1,0.0,1.0
1695,2014,GO,DEPUTADO FEDERAL,PCB,0,1,1,1.0,0.0
1696,2014,GO,DEPUTADO FEDERAL,PDT,0,1,1,1.0,0.0
1697,2014,GO,SENADOR,PCB,1,0,1,0.0,1.0
1698,2014,GO,SENADOR,PSD,1,0,1,0.0,1.0
1699,2014,GO,SENADOR,PT,0,1,1,1.0,0.0
1700,2014,GO,SENADOR,PSB,1,0,1,0.0,1.0
1701,2014,GO,SENADOR,PSOL,1,0,1,0.0,1.0
1702,2014,GO,SENADOR,DEM,1,0,1,0.0,1.0
1703,2014,GO,SENADOR,PSDC,1,0,1,0.0,1.0
1704,2018,GO,DEPUTADO ESTADUAL,PTB,16,7,23,0.30434782608695654,0.6956521739130435
1705,2018,GO,DEPUTADO ESTADUAL,PRP,29,13,42,0.30952380952380953,0.6904761904761905
1706,2018,GO,DEPUTADO ESTADUAL,PSDB,17,7,24,0.2916666666666667,0.7083333333333334
1707,2018,GO,DEPUTADO ESTADUAL,DC,34,18,52,0.34615384615384615,0.6538461538461539
1708,2018,GO,DEPUTADO ESTADUAL,PSL,41,18,59,0.3050847457627119,0.6949152542372882
1709,2018,GO,DEPUTADO ESTADUAL,PODE,17,6,23,0.2608695652173913,0.7391304347826086
1710,2018,GO,DEPUTADO ESTADUAL,PHS,32,16,48,0.3333333333333333,0.6666666666666666
1711,2018,GO,DEPUTADO ESTADUAL,MDB,24,12,36,0.3333333333333333,0.6666666666666666
1712,2018,GO,DEPUTADO ESTADUAL,PPS,7,5,12,0.4166666666666667,0.5833333333333334
1713,2018,GO,DEPUTADO ESTADUAL,SOLIDARIEDADE,36,16,52,0.3076923076923077,0.6923076923076923
1714,2018,GO,DEPUTADO ESTADUAL,PRTB,17,11,28,0.39285714285714285,0.6071428571428571
1715,2018,GO,DEPUTADO ESTADUAL,PATRI,32,14,46,0.30434782608695654,0.6956521739130435
1716,2018,GO,DEPUTADO ESTADUAL,PC do B,13,10,23,0.43478260869565216,0.5652173913043478
1717,2018,GO,DEPUTADO ESTADUAL,PRB,12,5,17,0.29411764705882354,0.7058823529411765
1718,2018,GO,DEPUTADO ESTADUAL,REDE,37,16,53,0.3018867924528302,0.6981132075471698
1719,2018,GO,DEPUTADO ESTADUAL,PROS,39,17,56,0.30357142857142855,0.6964285714285714
1720,2018,GO,DEPUTADO ESTADUAL,PSOL,19,9,28,0.32142857142857145,0.6785714285714286
1721,2018,GO,DEPUTADO ESTADUAL,PMN,26,8,34,0.23529411764705882,0.7647058823529411
1722,2018,GO,DEPUTADO ESTADUAL,PDT,18,9,27,0.3333333333333333,0.6666666666666666
1723,2018,GO,DEPUTADO ESTADUAL,PSB,13,6,19,0.3157894736842105,0.6842105263157895
1724,2018,GO,DEPUTADO ESTADUAL,AVANTE,10,3,13,0.23076923076923078,0.7692307692307693
1725,2018,GO,DEPUTADO ESTADUAL,PSC,17,6,23,0.2608695652173913,0.7391304347826086
1726,2018,GO,DEPUTADO ESTADUAL,PTC,3,1,4,0.25,0.75
1727,2018,GO,DEPUTADO ESTADUAL,PP,25,16,41,0.3902439024390244,0.6097560975609756
1728,2018,GO,DEPUTADO ESTADUAL,PR,9,4,13,0.3076923076923077,0.6923076923076923
1729,2018,GO,DEPUTADO ESTADUAL,PSD,13,6,19,0.3157894736842105,0.6842105263157895
1730,2018,GO,DEPUTADO ESTADUAL,DEM,21,11,32,0.34375,0.65625
1731,2018,GO,DEPUTADO ESTADUAL,PT,22,9,31,0.2903225806451613,0.7096774193548387
1732,2018,GO,DEPUTADO ESTADUAL,PV,5,3,8,0.375,0.625
1733,2018,GO,DEPUTADO ESTADUAL,PCO,0,1,1,1.0,0.0
1734,2018,GO,DEPUTADO ESTADUAL,PMB,3,2,5,0.4,0.6
1735,2018,GO,DEPUTADO ESTADUAL,PCB,1,0,1,0.0,1.0
1736,2018,GO,DEPUTADO FEDERAL,MDB,12,7,19,0.3684210526315789,0.631578947368421
1737,2018,GO,DEPUTADO FEDERAL,PC do B,3,4,7,0.5714285714285714,0.42857142857142855
1738,2018,GO,DEPUTADO FEDERAL,PATRI,7,2,9,0.2222222222222222,0.7777777777777778
1739,2018,GO,DEPUTADO FEDERAL,PTB,3,0,3,0.0,1.0
1740,2018,GO,DEPUTADO FEDERAL,PSDB,6,3,9,0.3333333333333333,0.6666666666666666
1741,2018,GO,DEPUTADO FEDERAL,PT,12,5,17,0.29411764705882354,0.7058823529411765
1742,2018,GO,DEPUTADO FEDERAL,PSD,2,3,5,0.6,0.4
1743,2018,GO,DEPUTADO FEDERAL,PTC,8,3,11,0.2727272727272727,0.7272727272727273
1744,2018,GO,DEPUTADO FEDERAL,REDE,4,3,7,0.42857142857142855,0.5714285714285714
1745,2018,GO,DEPUTADO FEDERAL,PSL,7,2,9,0.2222222222222222,0.7777777777777778
1746,2018,GO,DEPUTADO FEDERAL,PRP,3,2,5,0.4,0.6
1747,2018,GO,DEPUTADO FEDERAL,PMN,2,3,5,0.6,0.4
1748,2018,GO,DEPUTADO FEDERAL,PRTB,7,3,10,0.3,0.7
1749,2018,GO,DEPUTADO FEDERAL,PSOL,13,6,19,0.3157894736842105,0.6842105263157895
1750,2018,GO,DEPUTADO FEDERAL,DC,8,5,13,0.38461538461538464,0.6153846153846154
1751,2018,GO,DEPUTADO FEDERAL,PODE,5,0,5,0.0,1.0
1752,2018,GO,DEPUTADO FEDERAL,NOVO,4,2,6,0.3333333333333333,0.6666666666666666
1753,2018,GO,DEPUTADO FEDERAL,PPS,1,0,1,0.0,1.0
1754,2018,GO,DEPUTADO FEDERAL,PHS,16,9,25,0.36,0.64
1755,2018,GO,DEPUTADO FEDERAL,DEM,4,3,7,0.42857142857142855,0.5714285714285714
1756,2018,GO,DEPUTADO FEDERAL,PP,5,1,6,0.16666666666666666,0.8333333333333334
1757,2018,GO,DEPUTADO FEDERAL,PSC,5,2,7,0.2857142857142857,0.7142857142857143
1758,2018,GO,DEPUTADO FEDERAL,AVANTE,5,1,6,0.16666666666666666,0.8333333333333334
1759,2018,GO,DEPUTADO FEDERAL,PSB,3,0,3,0.0,1.0
1760,2018,GO,DEPUTADO FEDERAL,SOLIDARIEDADE,1,0,1,0.0,1.0
1761,2018,GO,DEPUTADO FEDERAL,PCB,0,1,1,1.0,0.0
1762,2018,GO,DEPUTADO FEDERAL,PDT,1,1,2,0.5,0.5
1763,2018,GO,DEPUTADO FEDERAL,PRB,1,0,1,0.0,1.0
1764,2018,GO,DEPUTADO FEDERAL,PV,3,2,5,0.4,0.6
1765,2018,GO,DEPUTADO FEDERAL,PR,0,1,1,1.0,0.0
1766,2018,GO,DEPUTADO FEDERAL,PCO,0,1,1,1.0,0.0
1767,2018,GO,DEPUTADO FEDERAL,PROS,0,1,1,1.0,0.0
1768,2018,GO,DEPUTADO FEDERAL,PMB,1,0,1,0.0,1.0
1769,2018,GO,SENADOR,PCO,1,0,1,0.0,1.0
1770,2018,GO,SENADOR,PSDB,1,0,1,0.0,1.0
1771,2018,GO,SENADOR,PRP,1,0,1,0.0,1.0
1772,2018,GO,SENADOR,PT,1,1,2,0.5,0.5
1773,2018,GO,SENADOR,MDB,1,0,1,0.0,1.0
1774,2018,GO,SENADOR,PATRI,1,0,1,0.0,1.0
1775,2018,GO,SENADOR,DEM,1,0,1,0.0,1.0
1776,2018,GO,SENADOR,PCB,0,1,1,1.0,0.0
1777,2018,GO,SENADOR,PSB,0,1,1,1.0,0.0
1778,2018,GO,SENADOR,PP,1,0,1,0.0,1.0
1779,2018,GO,SENADOR,PSOL,1,0,1,0.0,1.0
1780,2010,MA,DEPUTADO ESTADUAL,PTC,28,2,30,0.06666666666666667,0.9333333333333333
1781,2010,MA,DEPUTADO ESTADUAL,PSB,15,2,17,0.11764705882352941,0.8823529411764706
1782,2010,MA,DEPUTADO ESTADUAL,PV,13,1,14,0.07142857142857142,0.9285714285714286
1783,2010,MA,DEPUTADO ESTADUAL,PR,16,3,19,0.15789473684210525,0.8421052631578947
1784,2010,MA,DEPUTADO ESTADUAL,PSDB,10,1,11,0.09090909090909091,0.9090909090909091
1785,2010,MA,DEPUTADO ESTADUAL,PSL,30,5,35,0.14285714285714285,0.8571428571428571
1786,2010,MA,DEPUTADO ESTADUAL,PMDB,11,3,14,0.21428571428571427,0.7857142857142857
1787,2010,MA,DEPUTADO ESTADUAL,PMN,16,1,17,0.058823529411764705,0.9411764705882353
1788,2010,MA,DEPUTADO ESTADUAL,PSC,11,5,16,0.3125,0.6875
1789,2010,MA,DEPUTADO ESTADUAL,PT do B,12,3,15,0.2,0.8
1790,2010,MA,DEPUTADO ESTADUAL,PDT,12,6,18,0.3333333333333333,0.6666666666666666
1791,2010,MA,DEPUTADO ESTADUAL,PT,30,10,40,0.25,0.75
1792,2010,MA,DEPUTADO ESTADUAL,PP,26,4,30,0.13333333333333333,0.8666666666666667
1793,2010,MA,DEPUTADO ESTADUAL,PC do B,30,2,32,0.0625,0.9375
1794,2010,MA,DEPUTADO ESTADUAL,PHS,12,0,12,0.0,1.0
1795,2010,MA,DEPUTADO ESTADUAL,PRP,6,0,6,0.0,1.0
1796,2010,MA,DEPUTADO ESTADUAL,PRTB,23,4,27,0.14814814814814814,0.8518518518518519
1797,2010,MA,DEPUTADO ESTADUAL,PRB,20,2,22,0.09090909090909091,0.9090909090909091
1798,2010,MA,DEPUTADO ESTADUAL,PTB,6,2,8,0.25,0.75
1799,2010,MA,DEPUTADO ESTADUAL,DEM,7,0,7,0.0,1.0
1800,2010,MA,DEPUTADO ESTADUAL,PPS,6,4,10,0.4,0.6
1801,2010,MA,DEPUTADO ESTADUAL,PSOL,10,0,10,0.0,1.0
1802,2010,MA,DEPUTADO ESTADUAL,PCB,3,1,4,0.25,0.75
1803,2010,MA,DEPUTADO ESTADUAL,PTN,5,0,5,0.0,1.0
1804,2010,MA,DEPUTADO ESTADUAL,PSTU,1,0,1,0.0,1.0
1805,2010,MA,DEPUTADO FEDERAL,PSL,17,2,19,0.10526315789473684,0.8947368421052632
1806,2010,MA,DEPUTADO FEDERAL,PMN,6,0,6,0.0,1.0
1807,2010,MA,DEPUTADO FEDERAL,PSB,14,1,15,0.06666666666666667,0.9333333333333333
1808,2010,MA,DEPUTADO FEDERAL,PHS,6,3,9,0.3333333333333333,0.6666666666666666
1809,2010,MA,DEPUTADO FEDERAL,PPS,8,0,8,0.0,1.0
1810,2010,MA,DEPUTADO FEDERAL,PRTB,8,0,8,0.0,1.0
1811,2010,MA,DEPUTADO FEDERAL,PV,2,1,3,0.3333333333333333,0.6666666666666666
1812,2010,MA,DEPUTADO FEDERAL,PSC,2,0,2,0.0,1.0
1813,2010,MA,DEPUTADO FEDERAL,PSOL,5,0,5,0.0,1.0
1814,2010,MA,DEPUTADO FEDERAL,PSDB,12,1,13,0.07692307692307693,0.9230769230769231
1815,2010,MA,DEPUTADO FEDERAL,PCB,1,0,1,0.0,1.0
1816,2010,MA,DEPUTADO FEDERAL,PR,7,0,7,0.0,1.0
1817,2010,MA,DEPUTADO FEDERAL,PRP,2,0,2,0.0,1.0
1818,2010,MA,DEPUTADO FEDERAL,PC do B,11,2,13,0.15384615384615385,0.8461538461538461
1819,2010,MA,DEPUTADO FEDERAL,PRB,1,2,3,0.6666666666666666,0.3333333333333333
1820,2010,MA,DEPUTADO FEDERAL,PTB,3,1,4,0.25,0.75
1821,2010,MA,DEPUTADO FEDERAL,PDT,8,1,9,0.1111111111111111,0.8888888888888888
1822,2010,MA,DEPUTADO FEDERAL,PT,6,2,8,0.25,0.75
1823,2010,MA,DEPUTADO FEDERAL,PTC,9,1,10,0.1,0.9
1824,2010,MA,DEPUTADO FEDERAL,PSTU,1,0,1,0.0,1.0
1825,2010,MA,DEPUTADO FEDERAL,PMDB,12,0,12,0.0,1.0
1826,2010,MA,DEPUTADO FEDERAL,DEM,3,1,4,0.25,0.75
1827,2010,MA,DEPUTADO FEDERAL,PT do B,5,3,8,0.375,0.625
1828,2010,MA,DEPUTADO FEDERAL,PP,3,0,3,0.0,1.0
1829,2010,MA,DEPUTADO FEDERAL,PSDC,1,0,1,0.0,1.0
1830,2010,MA,SENADOR,PC do B,1,0,1,0.0,1.0
1831,2010,MA,SENADOR,PCB,2,0,2,0.0,1.0
1832,2010,MA,SENADOR,PSTU,1,1,2,0.5,0.5
1833,2010,MA,SENADOR,PMDB,2,0,2,0.0,1.0
1834,2010,MA,SENADOR,PSDB,2,0,2,0.0,1.0
1835,2010,MA,SENADOR,PSB,1,0,1,0.0,1.0
1836,2010,MA,SENADOR,PSOL,1,1,2,0.5,0.5
1837,2014,MA,DEPUTADO ESTADUAL,PHS,16,9,25,0.36,0.64
1838,2014,MA,DEPUTADO ESTADUAL,PSC,13,4,17,0.23529411764705882,0.7647058823529411
1839,2014,MA,DEPUTADO ESTADUAL,PRB,9,5,14,0.35714285714285715,0.6428571428571429
1840,2014,MA,DEPUTADO ESTADUAL,PMDB,9,16,25,0.64,0.36
1841,2014,MA,DEPUTADO ESTADUAL,PPL,20,7,27,0.25925925925925924,0.7407407407407407
1842,2014,MA,DEPUTADO ESTADUAL,PTC,24,16,40,0.4,0.6
1843,2014,MA,DEPUTADO ESTADUAL,PEN,13,6,19,0.3157894736842105,0.6842105263157895
1844,2014,MA,DEPUTADO ESTADUAL,PMN,13,6,19,0.3157894736842105,0.6842105263157895
1845,2014,MA,DEPUTADO ESTADUAL,PRTB,24,10,34,0.29411764705882354,0.7058823529411765
1846,2014,MA,DEPUTADO ESTADUAL,PT,19,9,28,0.32142857142857145,0.6785714285714286
1847,2014,MA,DEPUTADO ESTADUAL,PSDC,28,16,44,0.36363636363636365,0.6363636363636364
1848,2014,MA,DEPUTADO ESTADUAL,PSL,36,16,52,0.3076923076923077,0.6923076923076923
1849,2014,MA,DEPUTADO ESTADUAL,PSOL,10,5,15,0.3333333333333333,0.6666666666666666
1850,2014,MA,DEPUTADO ESTADUAL,PDT,17,6,23,0.2608695652173913,0.7391304347826086
1851,2014,MA,DEPUTADO ESTADUAL,PSB,9,6,15,0.4,0.6
1852,2014,MA,DEPUTADO ESTADUAL,PC do B,26,14,40,0.35,0.65
1853,2014,MA,DEPUTADO ESTADUAL,PSDB,7,3,10,0.3,0.7
1854,2014,MA,DEPUTADO ESTADUAL,PR,11,3,14,0.21428571428571427,0.7857142857142857
1855,2014,MA,DEPUTADO ESTADUAL,PP,16,7,23,0.30434782608695654,0.6956521739130435
1856,2014,MA,DEPUTADO ESTADUAL,SD,19,7,26,0.2692307692307692,0.7307692307692307
1857,2014,MA,DEPUTADO ESTADUAL,PPS,12,5,17,0.29411764705882354,0.7058823529411765
1858,2014,MA,DEPUTADO ESTADUAL,PRP,10,4,14,0.2857142857142857,0.7142857142857143
1859,2014,MA,DEPUTADO ESTADUAL,PSD,0,2,2,1.0,0.0
1860,2014,MA,DEPUTADO ESTADUAL,PT do B,9,0,9,0.0,1.0
1861,2014,MA,DEPUTADO ESTADUAL,PTB,4,2,6,0.3333333333333333,0.6666666666666666
1862,2014,MA,DEPUTADO ESTADUAL,PSTU,2,2,4,0.5,0.5
1863,2014,MA,DEPUTADO ESTADUAL,PV,9,2,11,0.18181818181818182,0.8181818181818182
1864,2014,MA,DEPUTADO ESTADUAL,PTN,4,0,4,0.0,1.0
1865,2014,MA,DEPUTADO ESTADUAL,PCB,5,1,6,0.16666666666666666,0.8333333333333334
1866,2014,MA,DEPUTADO ESTADUAL,DEM,2,1,3,0.3333333333333333,0.6666666666666666
1867,2014,MA,DEPUTADO ESTADUAL,PROS,0,1,1,1.0,0.0
1868,2014,MA,DEPUTADO FEDERAL,PTC,14,7,21,0.3333333333333333,0.6666666666666666
1869,2014,MA,DEPUTADO FEDERAL,PMN,6,3,9,0.3333333333333333,0.6666666666666666
1870,2014,MA,DEPUTADO FEDERAL,PT do B,9,4,13,0.3076923076923077,0.6923076923076923
1871,2014,MA,DEPUTADO FEDERAL,PSL,16,7,23,0.30434782608695654,0.6956521739130435
1872,2014,MA,DEPUTADO FEDERAL,PPL,4,1,5,0.2,0.8
1873,2014,MA,DEPUTADO FEDERAL,PRB,3,0,3,0.0,1.0
1874,2014,MA,DEPUTADO FEDERAL,PR,5,1,6,0.16666666666666666,0.8333333333333334
1875,2014,MA,DEPUTADO FEDERAL,PSTU,2,2,4,0.5,0.5
1876,2014,MA,DEPUTADO FEDERAL,PSD,3,3,6,0.5,0.5
1877,2014,MA,DEPUTADO FEDERAL,PRP,4,2,6,0.3333333333333333,0.6666666666666666
1878,2014,MA,DEPUTADO FEDERAL,PRTB,10,3,13,0.23076923076923078,0.7692307692307693
1879,2014,MA,DEPUTADO FEDERAL,PDT,12,12,24,0.5,0.5
1880,2014,MA,DEPUTADO FEDERAL,PSB,7,5,12,0.4166666666666667,0.5833333333333334
1881,2014,MA,DEPUTADO FEDERAL,PPS,2,1,3,0.3333333333333333,0.6666666666666666
1882,2014,MA,DEPUTADO FEDERAL,PC do B,7,4,11,0.36363636363636365,0.6363636363636364
1883,2014,MA,DEPUTADO FEDERAL,PCB,4,1,5,0.2,0.8
1884,2014,MA,DEPUTADO FEDERAL,PMDB,7,5,12,0.4166666666666667,0.5833333333333334
1885,2014,MA,DEPUTADO FEDERAL,PTB,7,3,10,0.3,0.7
1886,2014,MA,DEPUTADO FEDERAL,PSDB,2,2,4,0.5,0.5
1887,2014,MA,DEPUTADO FEDERAL,PSC,2,2,4,0.5,0.5
1888,2014,MA,DEPUTADO FEDERAL,PEN,9,4,13,0.3076923076923077,0.6923076923076923
1889,2014,MA,DEPUTADO FEDERAL,PT,19,8,27,0.2962962962962963,0.7037037037037037
1890,2014,MA,DEPUTADO FEDERAL,PV,3,1,4,0.25,0.75
1891,2014,MA,DEPUTADO FEDERAL,PSDC,9,3,12,0.25,0.75
1892,2014,MA,DEPUTADO FEDERAL,PSOL,3,2,5,0.4,0.6
1893,2014,MA,DEPUTADO FEDERAL,PP,5,1,6,0.16666666666666666,0.8333333333333334
1894,2014,MA,DEPUTADO FEDERAL,SD,2,1,3,0.3333333333333333,0.6666666666666666
1895,2014,MA,DEPUTADO FEDERAL,DEM,2,0,2,0.0,1.0
1896,2014,MA,DEPUTADO FEDERAL,PHS,2,2,4,0.5,0.5
1897,2014,MA,DEPUTADO FEDERAL,PTN,2,0,2,0.0,1.0
1898,2014,MA,DEPUTADO FEDERAL,PROS,3,0,3,0.0,1.0
1899,2014,MA,SENADOR,PSOL,1,0,1,0.0,1.0
1900,2014,MA,SENADOR,PSB,1,0,1,0.0,1.0
1901,2014,MA,SENADOR,PSTU,1,0,1,0.0,1.0
1902,2014,MA,SENADOR,PPL,1,0,1,0.0,1.0
1903,2014,MA,SENADOR,PCB,1,0,1,0.0,1.0
1904,2014,MA,SENADOR,PMDB,1,0,1,0.0,1.0
1905,2018,MA,DEPUTADO ESTADUAL,SOLIDARIEDADE,15,8,23,0.34782608695652173,0.6521739130434783
1906,2018,MA,DEPUTADO ESTADUAL,PSDB,25,12,37,0.32432432432432434,0.6756756756756757
1907,2018,MA,DEPUTADO ESTADUAL,PSL,40,20,60,0.3333333333333333,0.6666666666666666
1908,2018,MA,DEPUTADO ESTADUAL,PV,4,4,8,0.5,0.5
1909,2018,MA,DEPUTADO ESTADUAL,PRTB,35,15,50,0.3,0.7
1910,2018,MA,DEPUTADO ESTADUAL,PMB,3,4,7,0.5714285714285714,0.42857142857142855
1911,2018,MA,DEPUTADO ESTADUAL,PT,26,15,41,0.36585365853658536,0.6341463414634146
1912,2018,MA,DEPUTADO ESTADUAL,PTB,8,5,13,0.38461538461538464,0.6153846153846154
1913,2018,MA,DEPUTADO ESTADUAL,PSC,14,3,17,0.17647058823529413,0.8235294117647058
1914,2018,MA,DEPUTADO ESTADUAL,PSB,5,3,8,0.375,0.625
1915,2018,MA,DEPUTADO ESTADUAL,PMN,20,13,33,0.3939393939393939,0.6060606060606061
1916,2018,MA,DEPUTADO ESTADUAL,PATRI,11,4,15,0.26666666666666666,0.7333333333333333
1917,2018,MA,DEPUTADO ESTADUAL,PRP,3,1,4,0.25,0.75
1918,2018,MA,DEPUTADO ESTADUAL,PSD,6,3,9,0.3333333333333333,0.6666666666666666
1919,2018,MA,DEPUTADO ESTADUAL,DEM,6,3,9,0.3333333333333333,0.6666666666666666
1920,2018,MA,DEPUTADO ESTADUAL,PDT,8,2,10,0.2,0.8
1921,2018,MA,DEPUTADO ESTADUAL,PP,3,1,4,0.25,0.75
1922,2018,MA,DEPUTADO ESTADUAL,PR,4,2,6,0.3333333333333333,0.6666666666666666
1923,2018,MA,DEPUTADO ESTADUAL,REDE,5,5,10,0.5,0.5
1924,2018,MA,DEPUTADO ESTADUAL,PHS,19,6,25,0.24,0.76
1925,2018,MA,DEPUTADO ESTADUAL,DC,11,5,16,0.3125,0.6875
1926,2018,MA,DEPUTADO ESTADUAL,PSOL,12,6,18,0.3333333333333333,0.6666666666666666
1927,2018,MA,DEPUTADO ESTADUAL,PPS,6,3,9,0.3333333333333333,0.6666666666666666
1928,2018,MA,DEPUTADO ESTADUAL,PPL,10,2,12,0.16666666666666666,0.8333333333333334
1929,2018,MA,DEPUTADO ESTADUAL,PC do B,10,4,14,0.2857142857142857,0.7142857142857143
1930,2018,MA,DEPUTADO ESTADUAL,PODE,18,5,23,0.21739130434782608,0.782608695652174
1931,2018,MA,DEPUTADO ESTADUAL,MDB,12,5,17,0.29411764705882354,0.7058823529411765
1932,2018,MA,DEPUTADO ESTADUAL,PTC,1,1,2,0.5,0.5
1933,2018,MA,DEPUTADO ESTADUAL,PCB,1,2,3,0.6666666666666666,0.3333333333333333
1934,2018,MA,DEPUTADO ESTADUAL,PRB,6,4,10,0.4,0.6
1935,2018,MA,DEPUTADO ESTADUAL,PROS,5,4,9,0.4444444444444444,0.5555555555555556
1936,2018,MA,DEPUTADO ESTADUAL,PSTU,1,1,2,0.5,0.5
1937,2018,MA,DEPUTADO ESTADUAL,AVANTE,1,0,1,0.0,1.0
1938,2018,MA,DEPUTADO ESTADUAL,PCO,1,0,1,0.0,1.0
1939,2018,MA,DEPUTADO FEDERAL,PROS,2,1,3,0.3333333333333333,0.6666666666666666
1940,2018,MA,DEPUTADO FEDERAL,PT,18,9,27,0.3333333333333333,0.6666666666666666
1941,2018,MA,DEPUTADO FEDERAL,PSL,15,9,24,0.375,0.625
1942,2018,MA,DEPUTADO FEDERAL,PSDB,9,3,12,0.25,0.75
1943,2018,MA,DEPUTADO FEDERAL,PRP,2,0,2,0.0,1.0
1944,2018,MA,DEPUTADO FEDERAL,PV,6,1,7,0.14285714285714285,0.8571428571428571
1945,2018,MA,DEPUTADO FEDERAL,MDB,5,4,9,0.4444444444444444,0.5555555555555556
1946,2018,MA,DEPUTADO FEDERAL,PSOL,9,6,15,0.4,0.6
1947,2018,MA,DEPUTADO FEDERAL,DC,2,1,3,0.3333333333333333,0.6666666666666666
1948,2018,MA,DEPUTADO FEDERAL,PTB,2,1,3,0.3333333333333333,0.6666666666666666
1949,2018,MA,DEPUTADO FEDERAL,PRB,1,0,1,0.0,1.0
1950,2018,MA,DEPUTADO FEDERAL,PSB,2,2,4,0.5,0.5
1951,2018,MA,DEPUTADO FEDERAL,PMN,12,2,14,0.14285714285714285,0.8571428571428571
1952,2018,MA,DEPUTADO FEDERAL,PR,3,1,4,0.25,0.75
1953,2018,MA,DEPUTADO FEDERAL,PHS,7,7,14,0.5,0.5
1954,2018,MA,DEPUTADO FEDERAL,REDE,3,2,5,0.4,0.6
1955,2018,MA,DEPUTADO FEDERAL,PATRI,5,1,6,0.16666666666666666,0.8333333333333334
1956,2018,MA,DEPUTADO FEDERAL,PC do B,2,2,4,0.5,0.5
1957,2018,MA,DEPUTADO FEDERAL,PDT,5,3,8,0.375,0.625
1958,2018,MA,DEPUTADO FEDERAL,PSD,2,0,2,0.0,1.0
1959,2018,MA,DEPUTADO FEDERAL,PP,3,2,5,0.4,0.6
1960,2018,MA,DEPUTADO FEDERAL,PODE,3,2,5,0.4,0.6
1961,2018,MA,DEPUTADO FEDERAL,PTC,3,1,4,0.25,0.75
1962,2018,MA,DEPUTADO FEDERAL,PCB,2,1,3,0.3333333333333333,0.6666666666666666
1963,2018,MA,DEPUTADO FEDERAL,PSTU,2,1,3,0.3333333333333333,0.6666666666666666
1964,2018,MA,DEPUTADO FEDERAL,PPL,1,1,2,0.5,0.5
1965,2018,MA,DEPUTADO FEDERAL,PMB,0,3,3,1.0,0.0
1966,2018,MA,DEPUTADO FEDERAL,PSC,2,2,4,0.5,0.5
1967,2018,MA,DEPUTADO FEDERAL,PRTB,4,0,4,0.0,1.0
1968,2018,MA,DEPUTADO FEDERAL,PPS,0,1,1,1.0,0.0
1969,2018,MA,DEPUTADO FEDERAL,DEM,2,0,2,0.0,1.0
1970,2018,MA,DEPUTADO FEDERAL,SOLIDARIEDADE,2,0,2,0.0,1.0
1971,2018,MA,DEPUTADO FEDERAL,AVANTE,1,0,1,0.0,1.0
1972,2018,MA,SENADOR,PCB,1,0,1,0.0,1.0
1973,2018,MA,SENADOR,PSTU,1,1,2,0.5,0.5
1974,2018,MA,SENADOR,PV,1,0,1,0.0,1.0
1975,2018,MA,SENADOR,PSL,1,0,1,0.0,1.0
1976,2018,MA,SENADOR,PDT,1,0,1,0.0,1.0
1977,2018,MA,SENADOR,MDB,1,0,1,0.0,1.0
1978,2018,MA,SENADOR,PSDB,2,0,2,0.0,1.0
1979,2018,MA,SENADOR,PPS,0,1,1,1.0,0.0
1980,2018,MA,SENADOR,PSOL,1,0,1,0.0,1.0
1981,2010,MT,DEPUTADO ESTADUAL,PMDB,14,4,18,0.2222222222222222,0.7777777777777778
1982,2010,MT,DEPUTADO ESTADUAL,PT,10,4,14,0.2857142857142857,0.7142857142857143
1983,2010,MT,DEPUTADO ESTADUAL,PSDB,18,2,20,0.1,0.9
1984,2010,MT,DEPUTADO ESTADUAL,PSB,23,14,37,0.3783783783783784,0.6216216216216216
1985,2010,MT,DEPUTADO ESTADUAL,DEM,13,2,15,0.13333333333333333,0.8666666666666667
1986,2010,MT,DEPUTADO ESTADUAL,PTN,6,4,10,0.4,0.6
1987,2010,MT,DEPUTADO ESTADUAL,PPS,10,2,12,0.16666666666666666,0.8333333333333334
1988,2010,MT,DEPUTADO ESTADUAL,PP,23,7,30,0.23333333333333334,0.7666666666666667
1989,2010,MT,DEPUTADO ESTADUAL,PC do B,3,3,6,0.5,0.5
1990,2010,MT,DEPUTADO ESTADUAL,PDT,7,3,10,0.3,0.7
1991,2010,MT,DEPUTADO ESTADUAL,PT do B,4,4,8,0.5,0.5
1992,2010,MT,DEPUTADO ESTADUAL,PRB,12,5,17,0.29411764705882354,0.7058823529411765
1993,2010,MT,DEPUTADO ESTADUAL,PTB,20,5,25,0.2,0.8
1994,2010,MT,DEPUTADO ESTADUAL,PRP,5,1,6,0.16666666666666666,0.8333333333333334
1995,2010,MT,DEPUTADO ESTADUAL,PSC,8,2,10,0.2,0.8
1996,2010,MT,DEPUTADO ESTADUAL,PSL,6,3,9,0.3333333333333333,0.6666666666666666
1997,2010,MT,DEPUTADO ESTADUAL,PR,17,6,23,0.2608695652173913,0.7391304347826086
1998,2010,MT,DEPUTADO ESTADUAL,PV,9,3,12,0.25,0.75
1999,2010,MT,DEPUTADO ESTADUAL,PRTB,3,3,6,0.5,0.5
2000,2010,MT,DEPUTADO ESTADUAL,PTC,6,1,7,0.14285714285714285,0.8571428571428571
2001,2010,MT,DEPUTADO ESTADUAL,PSDC,4,1,5,0.2,0.8
2002,2010,MT,DEPUTADO ESTADUAL,PMN,4,1,5,0.2,0.8
2003,2010,MT,DEPUTADO ESTADUAL,PSOL,2,0,2,0.0,1.0
2004,2010,MT,DEPUTADO FEDERAL,PTB,6,0,6,0.0,1.0
2005,2010,MT,DEPUTADO FEDERAL,PMDB,5,2,7,0.2857142857142857,0.7142857142857143
2006,2010,MT,DEPUTADO FEDERAL,PPS,6,2,8,0.25,0.75
2007,2010,MT,DEPUTADO FEDERAL,PT,6,4,10,0.4,0.6
2008,2010,MT,DEPUTADO FEDERAL,PTC,4,0,4,0.0,1.0
2009,2010,MT,DEPUTADO FEDERAL,PC do B,1,1,2,0.5,0.5
2010,2010,MT,DEPUTADO FEDERAL,PR,6,2,8,0.25,0.75
2011,2010,MT,DEPUTADO FEDERAL,PDT,10,1,11,0.09090909090909091,0.9090909090909091
2012,2010,MT,DEPUTADO FEDERAL,PTN,1,4,5,0.8,0.2
2013,2010,MT,DEPUTADO FEDERAL,PRB,2,1,3,0.3333333333333333,0.6666666666666666
2014,2010,MT,DEPUTADO FEDERAL,PT do B,1,0,1,0.0,1.0
2015,2010,MT,DEPUTADO FEDERAL,PRP,1,1,2,0.5,0.5
2016,2010,MT,DEPUTADO FEDERAL,PP,9,0,9,0.0,1.0
2017,2010,MT,DEPUTADO FEDERAL,PV,1,1,2,0.5,0.5
2018,2010,MT,DEPUTADO FEDERAL,PSB,4,2,6,0.3333333333333333,0.6666666666666666
2019,2010,MT,DEPUTADO FEDERAL,PSDB,3,2,5,0.4,0.6
2020,2010,MT,DEPUTADO FEDERAL,PSOL,2,0,2,0.0,1.0
2021,2010,MT,DEPUTADO FEDERAL,DEM,3,0,3,0.0,1.0
2022,2010,MT,DEPUTADO FEDERAL,PHS,0,1,1,1.0,0.0
2023,2010,MT,DEPUTADO FEDERAL,PMN,0,1,1,1.0,0.0
2024,2010,MT,SENADOR,PV,2,0,2,0.0,1.0
2025,2010,MT,SENADOR,PSDB,1,0,1,0.0,1.0
2026,2010,MT,SENADOR,PR,1,0,1,0.0,1.0
2027,2010,MT,SENADOR,PT,1,0,1,0.0,1.0
2028,2010,MT,SENADOR,DEM,1,0,1,0.0,1.0
2029,2010,MT,SENADOR,PDT,1,0,1,0.0,1.0
2030,2010,MT,SENADOR,PSOL,1,0,1,0.0,1.0
2031,2014,MT,DEPUTADO ESTADUAL,PSDB,12,5,17,0.29411764705882354,0.7058823529411765
2032,2014,MT,DEPUTADO ESTADUAL,SD,16,6,22,0.2727272727272727,0.7272727272727273
2033,2014,MT,DEPUTADO ESTADUAL,PSB,16,7,23,0.30434782608695654,0.6956521739130435
2034,2014,MT,DEPUTADO ESTADUAL,PSL,5,5,10,0.5,0.5
2035,2014,MT,DEPUTADO ESTADUAL,PSC,11,5,16,0.3125,0.6875
2036,2014,MT,DEPUTADO ESTADUAL,PSOL,8,4,12,0.3333333333333333,0.6666666666666666
2037,2014,MT,DEPUTADO ESTADUAL,PSDC,2,0,2,0.0,1.0
2038,2014,MT,DEPUTADO ESTADUAL,PRB,3,2,5,0.4,0.6
2039,2014,MT,DEPUTADO ESTADUAL,PRP,6,3,9,0.3333333333333333,0.6666666666666666
2040,2014,MT,DEPUTADO ESTADUAL,PTB,21,8,29,0.27586206896551724,0.7241379310344828
2041,2014,MT,DEPUTADO ESTADUAL,PTN,5,3,8,0.375,0.625
2042,2014,MT,DEPUTADO ESTADUAL,PEN,2,2,4,0.5,0.5
2043,2014,MT,DEPUTADO ESTADUAL,PT do B,2,1,3,0.3333333333333333,0.6666666666666666
2044,2014,MT,DEPUTADO ESTADUAL,PROS,12,5,17,0.29411764705882354,0.7058823529411765
2045,2014,MT,DEPUTADO ESTADUAL,PC do B,4,2,6,0.3333333333333333,0.6666666666666666
2046,2014,MT,DEPUTADO ESTADUAL,PR,10,5,15,0.3333333333333333,0.6666666666666666
2047,2014,MT,DEPUTADO ESTADUAL,DEM,10,5,15,0.3333333333333333,0.6666666666666666
2048,2014,MT,DEPUTADO ESTADUAL,PT,8,5,13,0.38461538461538464,0.6153846153846154
2049,2014,MT,DEPUTADO ESTADUAL,PDT,15,6,21,0.2857142857142857,0.7142857142857143
2050,2014,MT,DEPUTADO ESTADUAL,PSD,19,11,30,0.36666666666666664,0.6333333333333333
2051,2014,MT,DEPUTADO ESTADUAL,PTC,8,4,12,0.3333333333333333,0.6666666666666666
2052,2014,MT,DEPUTADO ESTADUAL,PMDB,11,3,14,0.21428571428571427,0.7857142857142857
2053,2014,MT,DEPUTADO ESTADUAL,PV,9,4,13,0.3076923076923077,0.6923076923076923
2054,2014,MT,DEPUTADO ESTADUAL,PP,7,3,10,0.3,0.7
2055,2014,MT,DEPUTADO ESTADUAL,PRTB,5,3,8,0.375,0.625
2056,2014,MT,DEPUTADO ESTADUAL,PPS,2,0,2,0.0,1.0
2057,2014,MT,DEPUTADO FEDERAL,PSD,9,6,15,0.4,0.6
2058,2014,MT,DEPUTADO FEDERAL,PSDB,4,4,8,0.5,0.5
2059,2014,MT,DEPUTADO FEDERAL,PROS,8,3,11,0.2727272727272727,0.7272727272727273
2060,2014,MT,DEPUTADO FEDERAL,SD,3,3,6,0.5,0.5
2061,2014,MT,DEPUTADO FEDERAL,PDT,3,1,4,0.25,0.75
2062,2014,MT,DEPUTADO FEDERAL,PTC,1,0,1,0.0,1.0
2063,2014,MT,DEPUTADO FEDERAL,PSB,4,0,4,0.0,1.0
2064,2014,MT,DEPUTADO FEDERAL,PRTB,1,0,1,0.0,1.0
2065,2014,MT,DEPUTADO FEDERAL,PSOL,3,2,5,0.4,0.6
2066,2014,MT,DEPUTADO FEDERAL,PTN,1,0,1,0.0,1.0
2067,2014,MT,DEPUTADO FEDERAL,PT do B,5,2,7,0.2857142857142857,0.7142857142857143
2068,2014,MT,DEPUTADO FEDERAL,PRP,1,1,2,0.5,0.5
2069,2014,MT,DEPUTADO FEDERAL,PC do B,2,1,3,0.3333333333333333,0.6666666666666666
2070,2014,MT,DEPUTADO FEDERAL,PMN,3,4,7,0.5714285714285714,0.42857142857142855
2071,2014,MT,DEPUTADO FEDERAL,PHS,8,1,9,0.1111111111111111,0.8888888888888888
2072,2014,MT,DEPUTADO FEDERAL,PR,3,1,4,0.25,0.75
2073,2014,MT,DEPUTADO FEDERAL,PV,0,2,2,1.0,0.0
2074,2014,MT,DEPUTADO FEDERAL,PSL,0,1,1,1.0,0.0
2075,2014,MT,DEPUTADO FEDERAL,PEN,2,0,2,0.0,1.0
2076,2014,MT,DEPUTADO FEDERAL,PSDC,1,0,1,0.0,1.0
2077,2014,MT,DEPUTADO FEDERAL,DEM,1,1,2,0.5,0.5
2078,2014,MT,DEPUTADO FEDERAL,PTB,2,0,2,0.0,1.0
2079,2014,MT,DEPUTADO FEDERAL,PMDB,4,2,6,0.3333333333333333,0.6666666666666666
2080,2014,MT,DEPUTADO FEDERAL,PRB,2,1,3,0.3333333333333333,0.6666666666666666
2081,2014,MT,DEPUTADO FEDERAL,PT,2,1,3,0.3333333333333333,0.6666666666666666
2082,2014,MT,DEPUTADO FEDERAL,PP,1,0,1,0.0,1.0
2083,2014,MT,DEPUTADO FEDERAL,PSC,1,0,1,0.0,1.0
2084,2014,MT,SENADOR,PSOL,1,0,1,0.0,1.0
2085,2014,MT,SENADOR,DEM,1,0,1,0.0,1.0
2086,2014,MT,SENADOR,PHS,1,0,1,0.0,1.0
2087,2014,MT,SENADOR,PSD,1,0,1,0.0,1.0
2088,2014,MT,SENADOR,PSDB,1,0,1,0.0,1.0
2089,2014,MT,SENADOR,PT do B,1,0,1,0.0,1.0
2090,2014,MT,SENADOR,PR,1,0,1,0.0,1.0
2091,2018,MT,DEPUTADO ESTADUAL,PRB,10,2,12,0.16666666666666666,0.8333333333333334
2092,2018,MT,DEPUTADO ESTADUAL,PSB,11,3,14,0.21428571428571427,0.7857142857142857
2093,2018,MT,DEPUTADO ESTADUAL,PSC,3,2,5,0.4,0.6
2094,2018,MT,DEPUTADO ESTADUAL,PP,10,6,16,0.375,0.625
2095,2018,MT,DEPUTADO ESTADUAL,PSDB,20,10,30,0.3333333333333333,0.6666666666666666
2096,2018,MT,DEPUTADO ESTADUAL,PSD,8,2,10,0.2,0.8
2097,2018,MT,DEPUTADO ESTADUAL,PRP,2,2,4,0.5,0.5
2098,2018,MT,DEPUTADO ESTADUAL,MDB,10,6,16,0.375,0.625
2099,2018,MT,DEPUTADO ESTADUAL,PPS,12,7,19,0.3684210526315789,0.631578947368421
2100,2018,MT,DEPUTADO ESTADUAL,PATRI,5,2,7,0.2857142857142857,0.7142857142857143
2101,2018,MT,DEPUTADO ESTADUAL,PSOL,2,1,3,0.3333333333333333,0.6666666666666666
2102,2018,MT,DEPUTADO ESTADUAL,PV,22,9,31,0.2903225806451613,0.7096774193548387
2103,2018,MT,DEPUTADO ESTADUAL,PSL,24,11,35,0.3142857142857143,0.6857142857142857
2104,2018,MT,DEPUTADO ESTADUAL,SOLIDARIEDADE,15,5,20,0.25,0.75
2105,2018,MT,DEPUTADO ESTADUAL,DC,7,4,11,0.36363636363636365,0.6363636363636364
2106,2018,MT,DEPUTADO ESTADUAL,PMN,6,2,8,0.25,0.75
2107,2018,MT,DEPUTADO ESTADUAL,PPL,8,3,11,0.2727272727272727,0.7272727272727273
2108,2018,MT,DEPUTADO ESTADUAL,REDE,10,5,15,0.3333333333333333,0.6666666666666666
2109,2018,MT,DEPUTADO ESTADUAL,PDT,6,2,8,0.25,0.75
2110,2018,MT,DEPUTADO ESTADUAL,PODE,9,4,13,0.3076923076923077,0.6923076923076923
2111,2018,MT,DEPUTADO ESTADUAL,PROS,8,3,11,0.2727272727272727,0.7272727272727273
2112,2018,MT,DEPUTADO ESTADUAL,PCO,0,1,1,1.0,0.0
2113,2018,MT,DEPUTADO ESTADUAL,DEM,7,3,10,0.3,0.7
2114,2018,MT,DEPUTADO ESTADUAL,PT,5,1,6,0.16666666666666666,0.8333333333333334
2115,2018,MT,DEPUTADO ESTADUAL,PTB,6,3,9,0.3333333333333333,0.6666666666666666
2116,2018,MT,DEPUTADO ESTADUAL,PRTB,1,0,1,0.0,1.0
2117,2018,MT,DEPUTADO ESTADUAL,PR,7,5,12,0.4166666666666667,0.5833333333333334
2118,2018,MT,DEPUTADO ESTADUAL,PC do B,1,2,3,0.6666666666666666,0.3333333333333333
2119,2018,MT,DEPUTADO ESTADUAL,AVANTE,2,1,3,0.3333333333333333,0.6666666666666666
2120,2018,MT,DEPUTADO ESTADUAL,PTC,1,1,2,0.5,0.5
2121,2018,MT,DEPUTADO FEDERAL,AVANTE,5,2,7,0.2857142857142857,0.7142857142857143
2122,2018,MT,DEPUTADO FEDERAL,PT,0,2,2,1.0,0.0
2123,2018,MT,DEPUTADO FEDERAL,PV,5,4,9,0.4444444444444444,0.5555555555555556
2124,2018,MT,DEPUTADO FEDERAL,PATRI,3,0,3,0.0,1.0
2125,2018,MT,DEPUTADO FEDERAL,DEM,1,2,3,0.6666666666666666,0.3333333333333333
2126,2018,MT,DEPUTADO FEDERAL,PP,2,0,2,0.0,1.0
2127,2018,MT,DEPUTADO FEDERAL,SOLIDARIEDADE,1,1,2,0.5,0.5
2128,2018,MT,DEPUTADO FEDERAL,PRTB,6,5,11,0.45454545454545453,0.5454545454545454
2129,2018,MT,DEPUTADO FEDERAL,PHS,3,0,3,0.0,1.0
2130,2018,MT,DEPUTADO FEDERAL,PRB,0,1,1,1.0,0.0
2131,2018,MT,DEPUTADO FEDERAL,PSL,2,3,5,0.6,0.4
2132,2018,MT,DEPUTADO FEDERAL,PSC,3,4,7,0.5714285714285714,0.42857142857142855
2133,2018,MT,DEPUTADO FEDERAL,PRP,2,1,3,0.3333333333333333,0.6666666666666666
2134,2018,MT,DEPUTADO FEDERAL,PODE,2,0,2,0.0,1.0
2135,2018,MT,DEPUTADO FEDERAL,PSOL,6,4,10,0.4,0.6
2136,2018,MT,DEPUTADO FEDERAL,MDB,4,2,6,0.3333333333333333,0.6666666666666666
2137,2018,MT,DEPUTADO FEDERAL,NOVO,9,4,13,0.3076923076923077,0.6923076923076923
2138,2018,MT,DEPUTADO FEDERAL,PR,2,0,2,0.0,1.0
2139,2018,MT,DEPUTADO FEDERAL,PSB,4,1,5,0.2,0.8
2140,2018,MT,DEPUTADO FEDERAL,PSDB,3,2,5,0.4,0.6
2141,2018,MT,DEPUTADO FEDERAL,PROS,2,2,4,0.5,0.5
2142,2018,MT,DEPUTADO FEDERAL,PDT,4,1,5,0.2,0.8
2143,2018,MT,DEPUTADO FEDERAL,REDE,6,1,7,0.14285714285714285,0.8571428571428571
2144,2018,MT,DEPUTADO FEDERAL,PC do B,1,1,2,0.5,0.5
2145,2018,MT,DEPUTADO FEDERAL,PSD,2,0,2,0.0,1.0
2146,2018,MT,DEPUTADO FEDERAL,PPS,4,1,5,0.2,0.8
2147,2018,MT,DEPUTADO FEDERAL,PTB,1,1,2,0.5,0.5
2148,2018,MT,DEPUTADO FEDERAL,PPL,1,2,3,0.6666666666666666,0.3333333333333333
2149,2018,MT,DEPUTADO FEDERAL,DC,4,1,5,0.2,0.8
2150,2018,MT,DEPUTADO FEDERAL,PTC,1,1,2,0.5,0.5
2151,2018,MT,DEPUTADO FEDERAL,PMN,1,0,1,0.0,1.0
2152,2018,MT,DEPUTADO FEDERAL,PMB,1,0,1,0.0,1.0
2153,2018,MT,DEPUTADO FEDERAL,PCO,1,0,1,0.0,1.0
2154,2018,MT,SENADOR,NOVO,1,0,1,0.0,1.0
2155,2018,MT,SENADOR,PPL,1,0,1,0.0,1.0
2156,2018,MT,SENADOR,PSD,1,0,1,0.0,1.0
2157,2018,MT,SENADOR,PSOL,2,0,2,0.0,1.0
2158,2018,MT,SENADOR,PRB,1,0,1,0.0,1.0
2159,2018,MT,SENADOR,PSDB,1,0,1,0.0,1.0
2160,2018,MT,SENADOR,PC do B,0,1,1,1.0,0.0
2161,2018,MT,SENADOR,REDE,1,0,1,0.0,1.0
2162,2018,MT,SENADOR,DEM,1,0,1,0.0,1.0
2163,2018,MT,SENADOR,PSL,0,1,1,1.0,0.0
2164,2010,MS,DEPUTADO ESTADUAL,PSC,7,4,11,0.36363636363636365,0.6363636363636364
2165,2010,MS,DEPUTADO ESTADUAL,PHS,5,5,10,0.5,0.5
2166,2010,MS,DEPUTADO ESTADUAL,PMN,9,6,15,0.4,0.6
2167,2010,MS,DEPUTADO ESTADUAL,PTB,11,4,15,0.26666666666666666,0.7333333333333333
2168,2010,MS,DEPUTADO ESTADUAL,PTC,11,2,13,0.15384615384615385,0.8461538461538461
2169,2010,MS,DEPUTADO ESTADUAL,PRP,5,2,7,0.2857142857142857,0.7142857142857143
2170,2010,MS,DEPUTADO ESTADUAL,PV,30,7,37,0.1891891891891892,0.8108108108108109
2171,2010,MS,DEPUTADO ESTADUAL,PPS,9,3,12,0.25,0.75
2172,2010,MS,DEPUTADO ESTADUAL,PSDB,10,6,16,0.375,0.625
2173,2010,MS,DEPUTADO ESTADUAL,PP,7,4,11,0.36363636363636365,0.6363636363636364
2174,2010,MS,DEPUTADO ESTADUAL,PSL,9,0,9,0.0,1.0
2175,2010,MS,DEPUTADO ESTADUAL,PT,14,5,19,0.2631578947368421,0.7368421052631579
2176,2010,MS,DEPUTADO ESTADUAL,PT do B,9,2,11,0.18181818181818182,0.8181818181818182
2177,2010,MS,DEPUTADO ESTADUAL,DEM,6,2,8,0.25,0.75
2178,2010,MS,DEPUTADO ESTADUAL,PDT,12,2,14,0.14285714285714285,0.8571428571428571
2179,2010,MS,DEPUTADO ESTADUAL,PSB,6,4,10,0.4,0.6
2180,2010,MS,DEPUTADO ESTADUAL,PR,4,0,4,0.0,1.0
2181,2010,MS,DEPUTADO ESTADUAL,PSOL,7,0,7,0.0,1.0
2182,2010,MS,DEPUTADO ESTADUAL,PMDB,11,6,17,0.35294117647058826,0.6470588235294118
2183,2010,MS,DEPUTADO ESTADUAL,PC do B,8,0,8,0.0,1.0
2184,2010,MS,DEPUTADO ESTADUAL,PTN,3,1,4,0.25,0.75
2185,2010,MS,DEPUTADO ESTADUAL,PSDC,2,0,2,0.0,1.0
2186,2010,MS,DEPUTADO ESTADUAL,PRB,3,2,5,0.4,0.6
2187,2010,MS,DEPUTADO ESTADUAL,PRTB,2,1,3,0.3333333333333333,0.6666666666666666
2188,2010,MS,DEPUTADO FEDERAL,DEM,3,1,4,0.25,0.75
2189,2010,MS,DEPUTADO FEDERAL,PMDB,6,3,9,0.3333333333333333,0.6666666666666666
2190,2010,MS,DEPUTADO FEDERAL,PTB,5,3,8,0.375,0.625
2191,2010,MS,DEPUTADO FEDERAL,PT,6,2,8,0.25,0.75
2192,2010,MS,DEPUTADO FEDERAL,PP,1,0,1,0.0,1.0
2193,2010,MS,DEPUTADO FEDERAL,PSDB,4,1,5,0.2,0.8
2194,2010,MS,DEPUTADO FEDERAL,PTN,1,0,1,0.0,1.0
2195,2010,MS,DEPUTADO FEDERAL,PPS,3,2,5,0.4,0.6
2196,2010,MS,DEPUTADO FEDERAL,PSL,0,2,2,1.0,0.0
2197,2010,MS,DEPUTADO FEDERAL,PTC,1,0,1,0.0,1.0
2198,2010,MS,DEPUTADO FEDERAL,PR,1,0,1,0.0,1.0
2199,2010,MS,DEPUTADO FEDERAL,PRB,1,1,2,0.5,0.5
2200,2010,MS,DEPUTADO FEDERAL,PMN,0,2,2,1.0,0.0
2201,2010,MS,DEPUTADO FEDERAL,PSOL,3,0,3,0.0,1.0
2202,2010,MS,DEPUTADO FEDERAL,PDT,4,2,6,0.3333333333333333,0.6666666666666666
2203,2010,MS,DEPUTADO FEDERAL,PSDC,1,0,1,0.0,1.0
2204,2010,MS,DEPUTADO FEDERAL,PV,2,0,2,0.0,1.0
2205,2010,MS,DEPUTADO FEDERAL,PT do B,3,1,4,0.25,0.75
2206,2010,MS,DEPUTADO FEDERAL,PHS,2,1,3,0.3333333333333333,0.6666666666666666
2207,2010,MS,DEPUTADO FEDERAL,PSC,0,2,2,1.0,0.0
2208,2010,MS,DEPUTADO FEDERAL,PRP,1,1,2,0.5,0.5
2209,2010,MS,DEPUTADO FEDERAL,PC do B,1,0,1,0.0,1.0
2210,2010,MS,DEPUTADO FEDERAL,PSB,1,0,1,0.0,1.0
2211,2010,MS,SENADOR,PDT,1,0,1,0.0,1.0
2212,2010,MS,SENADOR,PT,1,0,1,0.0,1.0
2213,2010,MS,SENADOR,PSOL,1,0,1,0.0,1.0
2214,2010,MS,SENADOR,DEM,1,0,1,0.0,1.0
2215,2010,MS,SENADOR,PMDB,1,0,1,0.0,1.0
2216,2014,MS,DEPUTADO ESTADUAL,PMN,5,0,5,0.0,1.0
2217,2014,MS,DEPUTADO ESTADUAL,PPS,5,1,6,0.16666666666666666,0.8333333333333334
2218,2014,MS,DEPUTADO ESTADUAL,PSC,7,5,12,0.4166666666666667,0.5833333333333334
2219,2014,MS,DEPUTADO ESTADUAL,PT do B,8,5,13,0.38461538461538464,0.6153846153846154
2220,2014,MS,DEPUTADO ESTADUAL,PMDB,21,12,33,0.36363636363636365,0.6363636363636364
2221,2014,MS,DEPUTADO ESTADUAL,PP,15,6,21,0.2857142857142857,0.7142857142857143
2222,2014,MS,DEPUTADO ESTADUAL,PSOL,12,5,17,0.29411764705882354,0.7058823529411765
2223,2014,MS,DEPUTADO ESTADUAL,PTN,34,22,56,0.39285714285714285,0.6071428571428571
2224,2014,MS,DEPUTADO ESTADUAL,PTC,19,9,28,0.32142857142857145,0.6785714285714286
2225,2014,MS,DEPUTADO ESTADUAL,PDT,17,7,24,0.2916666666666667,0.7083333333333334
2226,2014,MS,DEPUTADO ESTADUAL,PSB,9,1,10,0.1,0.9
2227,2014,MS,DEPUTADO ESTADUAL,SD,5,0,5,0.0,1.0
2228,2014,MS,DEPUTADO ESTADUAL,PSDB,17,11,28,0.39285714285714285,0.6071428571428571
2229,2014,MS,DEPUTADO ESTADUAL,PSD,7,6,13,0.46153846153846156,0.5384615384615384
2230,2014,MS,DEPUTADO ESTADUAL,PRP,11,7,18,0.3888888888888889,0.6111111111111112
2231,2014,MS,DEPUTADO ESTADUAL,PRB,4,0,4,0.0,1.0
2232,2014,MS,DEPUTADO ESTADUAL,PSL,9,4,13,0.3076923076923077,0.6923076923076923
2233,2014,MS,DEPUTADO ESTADUAL,PHS,8,7,15,0.4666666666666667,0.5333333333333333
2234,2014,MS,DEPUTADO ESTADUAL,PT,19,11,30,0.36666666666666664,0.6333333333333333
2235,2014,MS,DEPUTADO ESTADUAL,PV,13,9,22,0.4090909090909091,0.5909090909090909
2236,2014,MS,DEPUTADO ESTADUAL,PPL,4,2,6,0.3333333333333333,0.6666666666666666
2237,2014,MS,DEPUTADO ESTADUAL,PROS,3,1,4,0.25,0.75
2238,2014,MS,DEPUTADO ESTADUAL,PEN,5,1,6,0.16666666666666666,0.8333333333333334
2239,2014,MS,DEPUTADO ESTADUAL,PRTB,2,0,2,0.0,1.0
2240,2014,MS,DEPUTADO ESTADUAL,PTB,11,3,14,0.21428571428571427,0.7857142857142857
2241,2014,MS,DEPUTADO ESTADUAL,PSDC,4,5,9,0.5555555555555556,0.4444444444444444
2242,2014,MS,DEPUTADO ESTADUAL,PC do B,6,3,9,0.3333333333333333,0.6666666666666666
2243,2014,MS,DEPUTADO ESTADUAL,DEM,2,1,3,0.3333333333333333,0.6666666666666666
2244,2014,MS,DEPUTADO ESTADUAL,PR,4,2,6,0.3333333333333333,0.6666666666666666
2245,2014,MS,DEPUTADO ESTADUAL,PSTU,1,1,2,0.5,0.5
2246,2014,MS,DEPUTADO FEDERAL,PSOL,4,2,6,0.3333333333333333,0.6666666666666666
2247,2014,MS,DEPUTADO FEDERAL,PMDB,10,3,13,0.23076923076923078,0.7692307692307693
2248,2014,MS,DEPUTADO FEDERAL,PPS,2,1,3,0.3333333333333333,0.6666666666666666
2249,2014,MS,DEPUTADO FEDERAL,PHS,6,5,11,0.45454545454545453,0.5454545454545454
2250,2014,MS,DEPUTADO FEDERAL,PRB,3,0,3,0.0,1.0
2251,2014,MS,DEPUTADO FEDERAL,PSD,5,1,6,0.16666666666666666,0.8333333333333334
2252,2014,MS,DEPUTADO FEDERAL,PSL,5,6,11,0.5454545454545454,0.45454545454545453
2253,2014,MS,DEPUTADO FEDERAL,PMN,0,1,1,1.0,0.0
2254,2014,MS,DEPUTADO FEDERAL,PSDB,5,4,9,0.4444444444444444,0.5555555555555556
2255,2014,MS,DEPUTADO FEDERAL,PDT,3,1,4,0.25,0.75
2256,2014,MS,DEPUTADO FEDERAL,PT,4,3,7,0.42857142857142855,0.5714285714285714
2257,2014,MS,DEPUTADO FEDERAL,PSB,1,3,4,0.75,0.25
2258,2014,MS,DEPUTADO FEDERAL,PT do B,4,2,6,0.3333333333333333,0.6666666666666666
2259,2014,MS,DEPUTADO FEDERAL,PP,4,2,6,0.3333333333333333,0.6666666666666666
2260,2014,MS,DEPUTADO FEDERAL,PROS,3,0,3,0.0,1.0
2261,2014,MS,DEPUTADO FEDERAL,PRP,7,3,10,0.3,0.7
2262,2014,MS,DEPUTADO FEDERAL,PPL,1,0,1,0.0,1.0
2263,2014,MS,DEPUTADO FEDERAL,DEM,3,1,4,0.25,0.75
2264,2014,MS,DEPUTADO FEDERAL,PR,1,1,2,0.5,0.5
2265,2014,MS,DEPUTADO FEDERAL,PTB,2,1,3,0.3333333333333333,0.6666666666666666
2266,2014,MS,DEPUTADO FEDERAL,SD,1,0,1,0.0,1.0
2267,2014,MS,DEPUTADO FEDERAL,PV,2,0,2,0.0,1.0
2268,2014,MS,DEPUTADO FEDERAL,PTN,1,0,1,0.0,1.0
2269,2014,MS,DEPUTADO FEDERAL,PSTU,1,1,2,0.5,0.5
2270,2014,MS,DEPUTADO FEDERAL,PC do B,1,0,1,0.0,1.0
2271,2014,MS,DEPUTADO FEDERAL,PSDC,2,1,3,0.3333333333333333,0.6666666666666666
2272,2014,MS,DEPUTADO FEDERAL,PTC,1,0,1,0.0,1.0
2273,2014,MS,DEPUTADO FEDERAL,PSC,2,1,3,0.3333333333333333,0.6666666666666666
2274,2014,MS,DEPUTADO FEDERAL,PEN,0,1,1,1.0,0.0
2275,2014,MS,DEPUTADO FEDERAL,PRTB,2,0,2,0.0,1.0
2276,2014,MS,SENADOR,PSTU,1,0,1,0.0,1.0
2277,2014,MS,SENADOR,PMDB,0,1,1,1.0,0.0
2278,2014,MS,SENADOR,PP,1,0,1,0.0,1.0
2279,2014,MS,SENADOR,PSD,1,0,1,0.0,1.0
2280,2014,MS,SENADOR,PT,1,0,1,0.0,1.0
2281,2014,MS,SENADOR,PSOL,1,0,1,0.0,1.0
2282,2018,MS,DEPUTADO ESTADUAL,PMN,4,3,7,0.42857142857142855,0.5714285714285714
2283,2018,MS,DEPUTADO ESTADUAL,PC do B,2,0,2,0.0,1.0
2284,2018,MS,DEPUTADO ESTADUAL,PP,5,3,8,0.375,0.625
2285,2018,MS,DEPUTADO ESTADUAL,PRB,11,3,14,0.21428571428571427,0.7857142857142857
2286,2018,MS,DEPUTADO ESTADUAL,PSD,9,5,14,0.35714285714285715,0.6428571428571429
2287,2018,MS,DEPUTADO ESTADUAL,PSB,5,0,5,0.0,1.0
2288,2018,MS,DEPUTADO ESTADUAL,PDT,18,10,28,0.35714285714285715,0.6428571428571429
2289,2018,MS,DEPUTADO ESTADUAL,PTC,8,3,11,0.2727272727272727,0.7272727272727273
2290,2018,MS,DEPUTADO ESTADUAL,PR,3,2,5,0.4,0.6
2291,2018,MS,DEPUTADO ESTADUAL,PV,19,10,29,0.3448275862068966,0.6551724137931034
2292,2018,MS,DEPUTADO ESTADUAL,PPS,3,0,3,0.0,1.0
2293,2018,MS,DEPUTADO ESTADUAL,MDB,17,10,27,0.37037037037037035,0.6296296296296297
2294,2018,MS,DEPUTADO ESTADUAL,PSC,7,6,13,0.46153846153846156,0.5384615384615384
2295,2018,MS,DEPUTADO ESTADUAL,PT,23,10,33,0.30303030303030304,0.696969696969697
2296,2018,MS,DEPUTADO ESTADUAL,SOLIDARIEDADE,6,1,7,0.14285714285714285,0.8571428571428571
2297,2018,MS,DEPUTADO ESTADUAL,PSDB,14,6,20,0.3,0.7
2298,2018,MS,DEPUTADO ESTADUAL,PSL,6,2,8,0.25,0.75
2299,2018,MS,DEPUTADO ESTADUAL,PODE,33,17,50,0.34,0.66
2300,2018,MS,DEPUTADO ESTADUAL,DC,2,3,5,0.6,0.4
2301,2018,MS,DEPUTADO ESTADUAL,PATRI,5,1,6,0.16666666666666666,0.8333333333333334
2302,2018,MS,DEPUTADO ESTADUAL,PSOL,9,5,14,0.35714285714285715,0.6428571428571429
2303,2018,MS,DEPUTADO ESTADUAL,DEM,3,0,3,0.0,1.0
2304,2018,MS,DEPUTADO ESTADUAL,AVANTE,5,2,7,0.2857142857142857,0.7142857142857143
2305,2018,MS,DEPUTADO ESTADUAL,PTB,8,3,11,0.2727272727272727,0.7272727272727273
2306,2018,MS,DEPUTADO ESTADUAL,PROS,2,3,5,0.6,0.4
2307,2018,MS,DEPUTADO ESTADUAL,PRTB,2,0,2,0.0,1.0
2308,2018,MS,DEPUTADO ESTADUAL,PHS,7,1,8,0.125,0.875
2309,2018,MS,DEPUTADO ESTADUAL,PMB,1,6,7,0.8571428571428571,0.14285714285714285
2310,2018,MS,DEPUTADO ESTADUAL,REDE,1,0,1,0.0,1.0
2311,2018,MS,DEPUTADO ESTADUAL,PCO,0,1,1,1.0,0.0
2312,2018,MS,DEPUTADO FEDERAL,PT,11,5,16,0.3125,0.6875
2313,2018,MS,DEPUTADO FEDERAL,PODE,4,1,5,0.2,0.8
2314,2018,MS,DEPUTADO FEDERAL,PSL,5,0,5,0.0,1.0
2315,2018,MS,DEPUTADO FEDERAL,DEM,4,1,5,0.2,0.8
2316,2018,MS,DEPUTADO FEDERAL,PMN,1,0,1,0.0,1.0
2317,2018,MS,DEPUTADO FEDERAL,AVANTE,0,1,1,1.0,0.0
2318,2018,MS,DEPUTADO FEDERAL,PPL,2,1,3,0.3333333333333333,0.6666666666666666
2319,2018,MS,DEPUTADO FEDERAL,PV,4,4,8,0.5,0.5
2320,2018,MS,DEPUTADO FEDERAL,MDB,8,6,14,0.42857142857142855,0.5714285714285714
2321,2018,MS,DEPUTADO FEDERAL,PSDB,2,3,5,0.6,0.4
2322,2018,MS,DEPUTADO FEDERAL,PSOL,4,2,6,0.3333333333333333,0.6666666666666666
2323,2018,MS,DEPUTADO FEDERAL,PROS,2,2,4,0.5,0.5
2324,2018,MS,DEPUTADO FEDERAL,PSC,3,0,3,0.0,1.0
2325,2018,MS,DEPUTADO FEDERAL,PRB,2,1,3,0.3333333333333333,0.6666666666666666
2326,2018,MS,DEPUTADO FEDERAL,PSD,2,0,2,0.0,1.0
2327,2018,MS,DEPUTADO FEDERAL,NOVO,3,2,5,0.4,0.6
2328,2018,MS,DEPUTADO FEDERAL,PC do B,3,1,4,0.25,0.75
2329,2018,MS,DEPUTADO FEDERAL,PCO,1,0,1,0.0,1.0
2330,2018,MS,DEPUTADO FEDERAL,PR,1,0,1,0.0,1.0
2331,2018,MS,DEPUTADO FEDERAL,PHS,4,0,4,0.0,1.0
2332,2018,MS,DEPUTADO FEDERAL,PDT,5,3,8,0.375,0.625
2333,2018,MS,DEPUTADO FEDERAL,PTC,0,1,1,1.0,0.0
2334,2018,MS,DEPUTADO FEDERAL,PRTB,0,3,3,1.0,0.0
2335,2018,MS,DEPUTADO FEDERAL,PPS,1,2,3,0.6666666666666666,0.3333333333333333
2336,2018,MS,DEPUTADO FEDERAL,PMB,0,1,1,1.0,0.0
2337,2018,MS,DEPUTADO FEDERAL,REDE,4,0,4,0.0,1.0
2338,2018,MS,DEPUTADO FEDERAL,PSB,1,1,2,0.5,0.5
2339,2018,MS,DEPUTADO FEDERAL,SOLIDARIEDADE,1,1,2,0.5,0.5
2340,2018,MS,DEPUTADO FEDERAL,PRP,2,0,2,0.0,1.0
2341,2018,MS,DEPUTADO FEDERAL,PTB,1,0,1,0.0,1.0
2342,2018,MS,DEPUTADO FEDERAL,PP,1,0,1,0.0,1.0
2343,2018,MS,DEPUTADO FEDERAL,PATRI,2,0,2,0.0,1.0
2344,2018,MS,DEPUTADO FEDERAL,DC,1,0,1,0.0,1.0
2345,2018,MS,SENADOR,PMB,1,0,1,0.0,1.0
2346,2018,MS,SENADOR,PRB,2,0,2,0.0,1.0
2347,2018,MS,SENADOR,PODE,1,0,1,0.0,1.0
2348,2018,MS,SENADOR,PC do B,1,0,1,0.0,1.0
2349,2018,MS,SENADOR,PPL,1,0,1,0.0,1.0
2350,2018,MS,SENADOR,PTC,1,0,1,0.0,1.0
2351,2018,MS,SENADOR,PT,1,0,1,0.0,1.0
2352,2018,MS,SENADOR,PTB,1,0,1,0.0,1.0
2353,2018,MS,SENADOR,MDB,1,0,1,0.0,1.0
2354,2018,MS,SENADOR,PSC,1,0,1,0.0,1.0
2355,2018,MS,SENADOR,PSDB,1,0,1,0.0,1.0
2356,2018,MS,SENADOR,PSOL,1,0,1,0.0,1.0
2357,2018,MS,SENADOR,PSL,0,1,1,1.0,0.0
2358,2010,MG,DEPUTADO ESTADUAL,PMDB,47,14,61,0.22950819672131148,0.7704918032786885
2359,2010,MG,DEPUTADO ESTADUAL,PMN,57,5,62,0.08064516129032258,0.9193548387096774
2360,2010,MG,DEPUTADO ESTADUAL,PTC,69,8,77,0.1038961038961039,0.8961038961038961
2361,2010,MG,DEPUTADO ESTADUAL,PSB,37,7,44,0.1590909090909091,0.8409090909090909
2362,2010,MG,DEPUTADO ESTADUAL,PT,68,16,84,0.19047619047619047,0.8095238095238095
2363,2010,MG,DEPUTADO ESTADUAL,PSDB,28,3,31,0.0967741935483871,0.9032258064516129
2364,2010,MG,DEPUTADO ESTADUAL,PTB,48,8,56,0.14285714285714285,0.8571428571428571
2365,2010,MG,DEPUTADO ESTADUAL,PR,38,1,39,0.02564102564102564,0.9743589743589743
2366,2010,MG,DEPUTADO ESTADUAL,PSOL,38,5,43,0.11627906976744186,0.8837209302325582
2367,2010,MG,DEPUTADO ESTADUAL,PC do B,49,17,66,0.25757575757575757,0.7424242424242424
2368,2010,MG,DEPUTADO ESTADUAL,PSDC,11,1,12,0.08333333333333333,0.9166666666666666
2369,2010,MG,DEPUTADO ESTADUAL,PSL,40,3,43,0.06976744186046512,0.9302325581395349
2370,2010,MG,DEPUTADO ESTADUAL,PSC,33,7,40,0.175,0.825
2371,2010,MG,DEPUTADO ESTADUAL,PDT,49,8,57,0.14035087719298245,0.8596491228070176
2372,2010,MG,DEPUTADO ESTADUAL,PV,46,11,57,0.19298245614035087,0.8070175438596491
2373,2010,MG,DEPUTADO ESTADUAL,PSTU,7,4,11,0.36363636363636365,0.6363636363636364
2374,2010,MG,DEPUTADO ESTADUAL,PPS,52,22,74,0.2972972972972973,0.7027027027027027
2375,2010,MG,DEPUTADO ESTADUAL,PHS,25,1,26,0.038461538461538464,0.9615384615384616
2376,2010,MG,DEPUTADO ESTADUAL,PRP,25,3,28,0.10714285714285714,0.8928571428571429
2377,2010,MG,DEPUTADO ESTADUAL,PRTB,45,4,49,0.08163265306122448,0.9183673469387755
2378,2010,MG,DEPUTADO ESTADUAL,PT do B,63,10,73,0.136986301369863,0.863013698630137
2379,2010,MG,DEPUTADO ESTADUAL,PRB,20,3,23,0.13043478260869565,0.8695652173913043
2380,2010,MG,DEPUTADO ESTADUAL,PP,16,2,18,0.1111111111111111,0.8888888888888888
2381,2010,MG,DEPUTADO ESTADUAL,DEM,11,3,14,0.21428571428571427,0.7857142857142857
2382,2010,MG,DEPUTADO ESTADUAL,PTN,10,2,12,0.16666666666666666,0.8333333333333334
2383,2010,MG,DEPUTADO ESTADUAL,PCO,0,1,1,1.0,0.0
2384,2010,MG,DEPUTADO ESTADUAL,PCB,2,0,2,0.0,1.0
2385,2010,MG,DEPUTADO FEDERAL,PMDB,35,12,47,0.2553191489361702,0.7446808510638298
2386,2010,MG,DEPUTADO FEDERAL,PHS,23,2,25,0.08,0.92
2387,2010,MG,DEPUTADO FEDERAL,PT do B,32,8,40,0.2,0.8
2388,2010,MG,DEPUTADO FEDERAL,PSB,32,1,33,0.030303030303030304,0.9696969696969697
2389,2010,MG,DEPUTADO FEDERAL,PT,35,7,42,0.16666666666666666,0.8333333333333334
2390,2010,MG,DEPUTADO FEDERAL,PDT,30,4,34,0.11764705882352941,0.8823529411764706
2391,2010,MG,DEPUTADO FEDERAL,PSL,20,1,21,0.047619047619047616,0.9523809523809523
2392,2010,MG,DEPUTADO FEDERAL,PTN,10,1,11,0.09090909090909091,0.9090909090909091
2393,2010,MG,DEPUTADO FEDERAL,PTC,41,1,42,0.023809523809523808,0.9761904761904762
2394,2010,MG,DEPUTADO FEDERAL,PMN,46,18,64,0.28125,0.71875
2395,2010,MG,DEPUTADO FEDERAL,PR,13,0,13,0.0,1.0
2396,2010,MG,DEPUTADO FEDERAL,PV,40,7,47,0.14893617021276595,0.851063829787234
2397,2010,MG,DEPUTADO FEDERAL,PSC,36,6,42,0.14285714285714285,0.8571428571428571
2398,2010,MG,DEPUTADO FEDERAL,PSDC,8,2,10,0.2,0.8
2399,2010,MG,DEPUTADO FEDERAL,PCB,2,0,2,0.0,1.0
2400,2010,MG,DEPUTADO FEDERAL,PRB,5,1,6,0.16666666666666666,0.8333333333333334
2401,2010,MG,DEPUTADO FEDERAL,PPS,11,4,15,0.26666666666666666,0.7333333333333333
2402,2010,MG,DEPUTADO FEDERAL,PTB,26,1,27,0.037037037037037035,0.9629629629629629
2403,2010,MG,DEPUTADO FEDERAL,PC do B,6,6,12,0.5,0.5
2404,2010,MG,DEPUTADO FEDERAL,PRTB,21,1,22,0.045454545454545456,0.9545454545454546
2405,2010,MG,DEPUTADO FEDERAL,PSOL,17,2,19,0.10526315789473684,0.8947368421052632
2406,2010,MG,DEPUTADO FEDERAL,PP,11,1,12,0.08333333333333333,0.9166666666666666
2407,2010,MG,DEPUTADO FEDERAL,PRP,5,2,7,0.2857142857142857,0.7142857142857143
2408,2010,MG,DEPUTADO FEDERAL,PSDB,15,4,19,0.21052631578947367,0.7894736842105263
2409,2010,MG,DEPUTADO FEDERAL,DEM,13,0,13,0.0,1.0
2410,2010,MG,DEPUTADO FEDERAL,PSTU,2,1,3,0.3333333333333333,0.6666666666666666
2411,2010,MG,DEPUTADO FEDERAL,PCO,1,0,1,0.0,1.0
2412,2010,MG,SENADOR,PRB,1,0,1,0.0,1.0
2413,2010,MG,SENADOR,PSDB,1,0,1,0.0,1.0
2414,2010,MG,SENADOR,PSTU,2,0,2,0.0,1.0
2415,2010,MG,SENADOR,PT,1,0,1,0.0,1.0
2416,2010,MG,SENADOR,PPS,1,0,1,0.0,1.0
2417,2010,MG,SENADOR,PHS,1,0,1,0.0,1.0
2418,2010,MG,SENADOR,PC do B,1,0,1,0.0,1.0
2419,2010,MG,SENADOR,PSOL,1,1,2,0.5,0.5
2420,2010,MG,SENADOR,PCB,1,0,1,0.0,1.0
2421,2010,MG,SENADOR,PCO,1,1,2,0.5,0.5
2422,2014,MG,DEPUTADO ESTADUAL,PR,34,18,52,0.34615384615384615,0.6538461538461539
2423,2014,MG,DEPUTADO ESTADUAL,PC do B,50,25,75,0.3333333333333333,0.6666666666666666
2424,2014,MG,DEPUTADO ESTADUAL,PTN,34,19,53,0.3584905660377358,0.6415094339622641
2425,2014,MG,DEPUTADO ESTADUAL,PDT,44,19,63,0.30158730158730157,0.6984126984126984
2426,2014,MG,DEPUTADO ESTADUAL,PSDB,26,14,40,0.35,0.65
2427,2014,MG,DEPUTADO ESTADUAL,PTB,39,17,56,0.30357142857142855,0.6964285714285714
2428,2014,MG,DEPUTADO ESTADUAL,PSB,28,22,50,0.44,0.56
2429,2014,MG,DEPUTADO ESTADUAL,PT do B,68,29,97,0.29896907216494845,0.7010309278350515
2430,2014,MG,DEPUTADO ESTADUAL,PSOL,17,7,24,0.2916666666666667,0.7083333333333334
2431,2014,MG,DEPUTADO ESTADUAL,PMN,32,18,50,0.36,0.64
2432,2014,MG,DEPUTADO ESTADUAL,PMDB,33,15,48,0.3125,0.6875
2433,2014,MG,DEPUTADO ESTADUAL,PV,28,13,41,0.3170731707317073,0.6829268292682927
2434,2014,MG,DEPUTADO ESTADUAL,PSC,29,13,42,0.30952380952380953,0.6904761904761905
2435,2014,MG,DEPUTADO ESTADUAL,PRP,28,15,43,0.3488372093023256,0.6511627906976745
2436,2014,MG,DEPUTADO ESTADUAL,PHS,45,10,55,0.18181818181818182,0.8181818181818182
2437,2014,MG,DEPUTADO ESTADUAL,PPS,18,10,28,0.35714285714285715,0.6428571428571429
2438,2014,MG,DEPUTADO ESTADUAL,PT,45,28,73,0.3835616438356164,0.6164383561643836
2439,2014,MG,DEPUTADO ESTADUAL,PSD,16,8,24,0.3333333333333333,0.6666666666666666
2440,2014,MG,DEPUTADO ESTADUAL,PP,9,3,12,0.25,0.75
2441,2014,MG,DEPUTADO ESTADUAL,PROS,16,4,20,0.2,0.8
2442,2014,MG,DEPUTADO ESTADUAL,PRB,13,7,20,0.35,0.65
2443,2014,MG,DEPUTADO ESTADUAL,PEN,38,20,58,0.3448275862068966,0.6551724137931034
2444,2014,MG,DEPUTADO ESTADUAL,PSL,23,10,33,0.30303030303030304,0.696969696969697
2445,2014,MG,DEPUTADO ESTADUAL,PCB,8,4,12,0.3333333333333333,0.6666666666666666
2446,2014,MG,DEPUTADO ESTADUAL,PTC,38,21,59,0.3559322033898305,0.6440677966101694
2447,2014,MG,DEPUTADO ESTADUAL,PPL,20,3,23,0.13043478260869565,0.8695652173913043
2448,2014,MG,DEPUTADO ESTADUAL,SD,7,3,10,0.3,0.7
2449,2014,MG,DEPUTADO ESTADUAL,PRTB,10,1,11,0.09090909090909091,0.9090909090909091
2450,2014,MG,DEPUTADO ESTADUAL,DEM,8,6,14,0.42857142857142855,0.5714285714285714
2451,2014,MG,DEPUTADO ESTADUAL,PSDC,8,2,10,0.2,0.8
2452,2014,MG,DEPUTADO ESTADUAL,PCO,2,0,2,0.0,1.0
2453,2014,MG,DEPUTADO ESTADUAL,PSTU,0,1,1,1.0,0.0
2454,2014,MG,DEPUTADO FEDERAL,PCO,1,0,1,0.0,1.0
2455,2014,MG,DEPUTADO FEDERAL,PTN,18,11,29,0.3793103448275862,0.6206896551724138
2456,2014,MG,DEPUTADO FEDERAL,PSD,9,5,14,0.35714285714285715,0.6428571428571429
2457,2014,MG,DEPUTADO FEDERAL,PSB,37,19,56,0.3392857142857143,0.6607142857142857
2458,2014,MG,DEPUTADO FEDERAL,PSDC,11,3,14,0.21428571428571427,0.7857142857142857
2459,2014,MG,DEPUTADO FEDERAL,PT,29,9,38,0.23684210526315788,0.7631578947368421
2460,2014,MG,DEPUTADO FEDERAL,PSTU,14,7,21,0.3333333333333333,0.6666666666666666
2461,2014,MG,DEPUTADO FEDERAL,PSOL,11,4,15,0.26666666666666666,0.7333333333333333
2462,2014,MG,DEPUTADO FEDERAL,PMDB,19,9,28,0.32142857142857145,0.6785714285714286
2463,2014,MG,DEPUTADO FEDERAL,PMN,14,7,21,0.3333333333333333,0.6666666666666666
2464,2014,MG,DEPUTADO FEDERAL,PR,7,1,8,0.125,0.875
2465,2014,MG,DEPUTADO FEDERAL,PDT,33,14,47,0.2978723404255319,0.7021276595744681
2466,2014,MG,DEPUTADO FEDERAL,PPL,8,4,12,0.3333333333333333,0.6666666666666666
2467,2014,MG,DEPUTADO FEDERAL,PROS,4,3,7,0.42857142857142855,0.5714285714285714
2468,2014,MG,DEPUTADO FEDERAL,PSDB,18,13,31,0.41935483870967744,0.5806451612903226
2469,2014,MG,DEPUTADO FEDERAL,PTB,16,8,24,0.3333333333333333,0.6666666666666666
2470,2014,MG,DEPUTADO FEDERAL,PT do B,50,21,71,0.29577464788732394,0.704225352112676
2471,2014,MG,DEPUTADO FEDERAL,PTC,27,13,40,0.325,0.675
2472,2014,MG,DEPUTADO FEDERAL,PPS,16,7,23,0.30434782608695654,0.6956521739130435
2473,2014,MG,DEPUTADO FEDERAL,PV,19,9,28,0.32142857142857145,0.6785714285714286
2474,2014,MG,DEPUTADO FEDERAL,PC do B,2,2,4,0.5,0.5
2475,2014,MG,DEPUTADO FEDERAL,PRP,6,4,10,0.4,0.6
2476,2014,MG,DEPUTADO FEDERAL,PEN,12,2,14,0.14285714285714285,0.8571428571428571
2477,2014,MG,DEPUTADO FEDERAL,DEM,12,5,17,0.29411764705882354,0.7058823529411765
2478,2014,MG,DEPUTADO FEDERAL,PHS,12,6,18,0.3333333333333333,0.6666666666666666
2479,2014,MG,DEPUTADO FEDERAL,PSL,18,12,30,0.4,0.6
2480,2014,MG,DEPUTADO FEDERAL,PSC,16,6,22,0.2727272727272727,0.7272727272727273
2481,2014,MG,DEPUTADO FEDERAL,PCB,7,3,10,0.3,0.7
2482,2014,MG,DEPUTADO FEDERAL,PRTB,8,1,9,0.1111111111111111,0.8888888888888888
2483,2014,MG,DEPUTADO FEDERAL,SD,8,4,12,0.3333333333333333,0.6666666666666666
2484,2014,MG,DEPUTADO FEDERAL,PP,7,2,9,0.2222222222222222,0.7777777777777778
2485,2014,MG,DEPUTADO FEDERAL,PRB,8,5,13,0.38461538461538464,0.6153846153846154
2486,2014,MG,SENADOR,PSB,0,1,1,1.0,0.0
2487,2014,MG,SENADOR,PMDB,1,0,1,0.0,1.0
2488,2014,MG,SENADOR,PCO,0,1,1,1.0,0.0
2489,2014,MG,SENADOR,PT do B,1,0,1,0.0,1.0
2490,2014,MG,SENADOR,PSDC,1,0,1,0.0,1.0
2491,2014,MG,SENADOR,PCB,1,0,1,0.0,1.0
2492,2014,MG,SENADOR,PSTU,1,0,1,0.0,1.0
2493,2014,MG,SENADOR,PSDB,1,0,1,0.0,1.0
2494,2018,MG,DEPUTADO ESTADUAL,REDE,26,7,33,0.21212121212121213,0.7878787878787878
2495,2018,MG,DEPUTADO ESTADUAL,PTB,38,22,60,0.36666666666666664,0.6333333333333333
2496,2018,MG,DEPUTADO ESTADUAL,PSB,46,16,62,0.25806451612903225,0.7419354838709677
2497,2018,MG,DEPUTADO ESTADUAL,DC,30,19,49,0.3877551020408163,0.6122448979591837
2498,2018,MG,DEPUTADO ESTADUAL,PC do B,39,19,58,0.3275862068965517,0.6724137931034483
2499,2018,MG,DEPUTADO ESTADUAL,PRP,58,21,79,0.26582278481012656,0.7341772151898734
2500,2018,MG,DEPUTADO ESTADUAL,PP,10,3,13,0.23076923076923078,0.7692307692307693
2501,2018,MG,DEPUTADO ESTADUAL,PSL,67,32,99,0.32323232323232326,0.6767676767676768
2502,2018,MG,DEPUTADO ESTADUAL,PDT,20,6,26,0.23076923076923078,0.7692307692307693
2503,2018,MG,DEPUTADO ESTADUAL,PRTB,55,28,83,0.3373493975903614,0.6626506024096386
2504,2018,MG,DEPUTADO ESTADUAL,AVANTE,68,28,96,0.2916666666666667,0.7083333333333334
2505,2018,MG,DEPUTADO ESTADUAL,PATRI,34,13,47,0.2765957446808511,0.723404255319149
2506,2018,MG,DEPUTADO ESTADUAL,PHS,46,20,66,0.30303030303030304,0.696969696969697
2507,2018,MG,DEPUTADO ESTADUAL,PSD,16,6,22,0.2727272727272727,0.7272727272727273
2508,2018,MG,DEPUTADO ESTADUAL,PPS,14,6,20,0.3,0.7
2509,2018,MG,DEPUTADO ESTADUAL,PR,8,4,12,0.3333333333333333,0.6666666666666666
2510,2018,MG,DEPUTADO ESTADUAL,SOLIDARIEDADE,43,19,62,0.3064516129032258,0.6935483870967742
2511,2018,MG,DEPUTADO ESTADUAL,PROS,45,19,64,0.296875,0.703125
2512,2018,MG,DEPUTADO ESTADUAL,PT,22,12,34,0.35294117647058826,0.6470588235294118
2513,2018,MG,DEPUTADO ESTADUAL,MDB,21,12,33,0.36363636363636365,0.6363636363636364
2514,2018,MG,DEPUTADO ESTADUAL,PPL,21,13,34,0.38235294117647056,0.6176470588235294
2515,2018,MG,DEPUTADO ESTADUAL,NOVO,16,8,24,0.3333333333333333,0.6666666666666666
2516,2018,MG,DEPUTADO ESTADUAL,PRB,5,6,11,0.5454545454545454,0.45454545454545453
2517,2018,MG,DEPUTADO ESTADUAL,DEM,21,7,28,0.25,0.75
2518,2018,MG,DEPUTADO ESTADUAL,PTC,32,17,49,0.3469387755102041,0.6530612244897959
2519,2018,MG,DEPUTADO ESTADUAL,PSDB,17,13,30,0.43333333333333335,0.5666666666666667
2520,2018,MG,DEPUTADO ESTADUAL,PSTU,3,4,7,0.5714285714285714,0.42857142857142855
2521,2018,MG,DEPUTADO ESTADUAL,PODE,18,2,20,0.1,0.9
2522,2018,MG,DEPUTADO ESTADUAL,PSOL,32,16,48,0.3333333333333333,0.6666666666666666
2523,2018,MG,DEPUTADO ESTADUAL,PSC,49,23,72,0.3194444444444444,0.6805555555555556
2524,2018,MG,DEPUTADO ESTADUAL,PMN,12,3,15,0.2,0.8
2525,2018,MG,DEPUTADO ESTADUAL,PV,10,6,16,0.375,0.625
2526,2018,MG,DEPUTADO ESTADUAL,PMB,3,1,4,0.25,0.75
2527,2018,MG,DEPUTADO ESTADUAL,PCB,1,0,1,0.0,1.0
2528,2018,MG,DEPUTADO ESTADUAL,PCO,1,0,1,0.0,1.0
2529,2018,MG,DEPUTADO FEDERAL,PSB,27,17,44,0.38636363636363635,0.6136363636363636
2530,2018,MG,DEPUTADO FEDERAL,AVANTE,56,24,80,0.3,0.7
2531,2018,MG,DEPUTADO FEDERAL,PRB,6,2,8,0.25,0.75
2532,2018,MG,DEPUTADO FEDERAL,NOVO,25,12,37,0.32432432432432434,0.6756756756756757
2533,2018,MG,DEPUTADO FEDERAL,PRTB,34,21,55,0.38181818181818183,0.6181818181818182
2534,2018,MG,DEPUTADO FEDERAL,PODE,19,9,28,0.32142857142857145,0.6785714285714286
2535,2018,MG,DEPUTADO FEDERAL,PDT,20,6,26,0.23076923076923078,0.7692307692307693
2536,2018,MG,DEPUTADO FEDERAL,PTB,14,8,22,0.36363636363636365,0.6363636363636364
2537,2018,MG,DEPUTADO FEDERAL,PRP,3,2,5,0.4,0.6
2538,2018,MG,DEPUTADO FEDERAL,MDB,13,8,21,0.38095238095238093,0.6190476190476191
2539,2018,MG,DEPUTADO FEDERAL,PSL,56,24,80,0.3,0.7
2540,2018,MG,DEPUTADO FEDERAL,PROS,24,11,35,0.3142857142857143,0.6857142857142857
2541,2018,MG,DEPUTADO FEDERAL,PCB,8,4,12,0.3333333333333333,0.6666666666666666
2542,2018,MG,DEPUTADO FEDERAL,PSOL,23,12,35,0.34285714285714286,0.6571428571428571
2543,2018,MG,DEPUTADO FEDERAL,PHS,52,22,74,0.2972972972972973,0.7027027027027027
2544,2018,MG,DEPUTADO FEDERAL,PPS,9,5,14,0.35714285714285715,0.6428571428571429
2545,2018,MG,DEPUTADO FEDERAL,REDE,22,3,25,0.12,0.88
2546,2018,MG,DEPUTADO FEDERAL,PR,6,0,6,0.0,1.0
2547,2018,MG,DEPUTADO FEDERAL,PV,11,5,16,0.3125,0.6875
2548,2018,MG,DEPUTADO FEDERAL,PT,19,8,27,0.2962962962962963,0.7037037037037037
2549,2018,MG,DEPUTADO FEDERAL,PSDB,11,9,20,0.45,0.55
2550,2018,MG,DEPUTADO FEDERAL,PC do B,6,3,9,0.3333333333333333,0.6666666666666666
2551,2018,MG,DEPUTADO FEDERAL,SOLIDARIEDADE,9,4,13,0.3076923076923077,0.6923076923076923
2552,2018,MG,DEPUTADO FEDERAL,PTC,18,14,32,0.4375,0.5625
2553,2018,MG,DEPUTADO FEDERAL,PSC,23,13,36,0.3611111111111111,0.6388888888888888
2554,2018,MG,DEPUTADO FEDERAL,PATRI,32,8,40,0.2,0.8
2555,2018,MG,DEPUTADO FEDERAL,PMN,16,4,20,0.2,0.8
2556,2018,MG,DEPUTADO FEDERAL,PSD,7,4,11,0.36363636363636365,0.6363636363636364
2557,2018,MG,DEPUTADO FEDERAL,DEM,13,4,17,0.23529411764705882,0.7647058823529411
2558,2018,MG,DEPUTADO FEDERAL,PPL,24,12,36,0.3333333333333333,0.6666666666666666
2559,2018,MG,DEPUTADO FEDERAL,PSTU,3,2,5,0.4,0.6
2560,2018,MG,DEPUTADO FEDERAL,PMB,4,4,8,0.5,0.5
2561,2018,MG,DEPUTADO FEDERAL,PP,8,1,9,0.1111111111111111,0.8888888888888888
2562,2018,MG,DEPUTADO FEDERAL,PCO,0,1,1,1.0,0.0
2563,2018,MG,DEPUTADO FEDERAL,DC,9,2,11,0.18181818181818182,0.8181818181818182
2564,2018,MG,SENADOR,PCO,0,1,1,1.0,0.0
2565,2018,MG,SENADOR,AVANTE,1,0,1,0.0,1.0
2566,2018,MG,SENADOR,PSTU,0,1,1,1.0,0.0
2567,2018,MG,SENADOR,PHS,1,0,1,0.0,1.0
2568,2018,MG,SENADOR,PDT,1,0,1,0.0,1.0
2569,2018,MG,SENADOR,PPL,2,0,2,0.0,1.0
2570,2018,MG,SENADOR,REDE,1,0,1,0.0,1.0
2571,2018,MG,SENADOR,DEM,1,0,1,0.0,1.0
2572,2018,MG,SENADOR,PT,1,1,2,0.5,0.5
2573,2018,MG,SENADOR,PCB,1,0,1,0.0,1.0
2574,2018,MG,SENADOR,NOVO,1,0,1,0.0,1.0
2575,2018,MG,SENADOR,PSOL,0,1,1,1.0,0.0
2576,2018,MG,SENADOR,SOLIDARIEDADE,1,0,1,0.0,1.0
2577,2010,PA,DEPUTADO ESTADUAL,PT,29,9,38,0.23684210526315788,0.7631578947368421
2578,2010,PA,DEPUTADO ESTADUAL,PSB,29,17,46,0.3695652173913043,0.6304347826086957
2579,2010,PA,DEPUTADO ESTADUAL,PMDB,32,16,48,0.3333333333333333,0.6666666666666666
2580,2010,PA,DEPUTADO ESTADUAL,PDT,22,9,31,0.2903225806451613,0.7096774193548387
2581,2010,PA,DEPUTADO ESTADUAL,PSC,30,9,39,0.23076923076923078,0.7692307692307693
2582,2010,PA,DEPUTADO ESTADUAL,PV,38,10,48,0.20833333333333334,0.7916666666666666
2583,2010,PA,DEPUTADO ESTADUAL,PSDB,12,8,20,0.4,0.6
2584,2010,PA,DEPUTADO ESTADUAL,PP,11,2,13,0.15384615384615385,0.8461538461538461
2585,2010,PA,DEPUTADO ESTADUAL,PTB,24,12,36,0.3333333333333333,0.6666666666666666
2586,2010,PA,DEPUTADO ESTADUAL,PRP,6,0,6,0.0,1.0
2587,2010,PA,DEPUTADO ESTADUAL,PMN,7,1,8,0.125,0.875
2588,2010,PA,DEPUTADO ESTADUAL,PC do B,43,19,62,0.3064516129032258,0.6935483870967742
2589,2010,PA,DEPUTADO ESTADUAL,PPS,35,18,53,0.33962264150943394,0.660377358490566
2590,2010,PA,DEPUTADO ESTADUAL,DEM,11,2,13,0.15384615384615385,0.8461538461538461
2591,2010,PA,DEPUTADO ESTADUAL,PRB,35,15,50,0.3,0.7
2592,2010,PA,DEPUTADO ESTADUAL,PTC,9,5,14,0.35714285714285715,0.6428571428571429
2593,2010,PA,DEPUTADO ESTADUAL,PSOL,12,6,18,0.3333333333333333,0.6666666666666666
2594,2010,PA,DEPUTADO ESTADUAL,PR,35,12,47,0.2553191489361702,0.7446808510638298
2595,2010,PA,DEPUTADO ESTADUAL,PHS,4,2,6,0.3333333333333333,0.6666666666666666
2596,2010,PA,DEPUTADO ESTADUAL,PRTB,3,0,3,0.0,1.0
2597,2010,PA,DEPUTADO ESTADUAL,PT do B,10,2,12,0.16666666666666666,0.8333333333333334
2598,2010,PA,DEPUTADO ESTADUAL,PSDC,4,5,9,0.5555555555555556,0.4444444444444444
2599,2010,PA,DEPUTADO ESTADUAL,PTN,3,1,4,0.25,0.75
2600,2010,PA,DEPUTADO ESTADUAL,PSTU,0,2,2,1.0,0.0
2601,2010,PA,DEPUTADO FEDERAL,DEM,6,1,7,0.14285714285714285,0.8571428571428571
2602,2010,PA,DEPUTADO FEDERAL,PSB,3,2,5,0.4,0.6
2603,2010,PA,DEPUTADO FEDERAL,PSDC,2,1,3,0.3333333333333333,0.6666666666666666
2604,2010,PA,DEPUTADO FEDERAL,PMN,6,0,6,0.0,1.0
2605,2010,PA,DEPUTADO FEDERAL,PSTU,1,0,1,0.0,1.0
2606,2010,PA,DEPUTADO FEDERAL,PSOL,13,5,18,0.2777777777777778,0.7222222222222222
2607,2010,PA,DEPUTADO FEDERAL,PSDB,14,12,26,0.46153846153846156,0.5384615384615384
2608,2010,PA,DEPUTADO FEDERAL,PV,1,2,3,0.6666666666666666,0.3333333333333333
2609,2010,PA,DEPUTADO FEDERAL,PT,9,6,15,0.4,0.6
2610,2010,PA,DEPUTADO FEDERAL,PDT,15,4,19,0.21052631578947367,0.7894736842105263
2611,2010,PA,DEPUTADO FEDERAL,PTB,13,1,14,0.07142857142857142,0.9285714285714286
2612,2010,PA,DEPUTADO FEDERAL,PRB,8,3,11,0.2727272727272727,0.7272727272727273
2613,2010,PA,DEPUTADO FEDERAL,PPS,5,2,7,0.2857142857142857,0.7142857142857143
2614,2010,PA,DEPUTADO FEDERAL,PMDB,19,8,27,0.2962962962962963,0.7037037037037037
2615,2010,PA,DEPUTADO FEDERAL,PSC,4,0,4,0.0,1.0
2616,2010,PA,DEPUTADO FEDERAL,PT do B,1,1,2,0.5,0.5
2617,2010,PA,DEPUTADO FEDERAL,PC do B,1,1,2,0.5,0.5
2618,2010,PA,DEPUTADO FEDERAL,PTN,1,0,1,0.0,1.0
2619,2010,PA,DEPUTADO FEDERAL,PP,1,0,1,0.0,1.0
2620,2010,PA,DEPUTADO FEDERAL,PTC,1,1,2,0.5,0.5
2621,2010,PA,DEPUTADO FEDERAL,PRP,2,0,2,0.0,1.0
2622,2010,PA,DEPUTADO FEDERAL,PHS,1,0,1,0.0,1.0
2623,2010,PA,DEPUTADO FEDERAL,PRTB,1,0,1,0.0,1.0
2624,2010,PA,DEPUTADO FEDERAL,PR,2,0,2,0.0,1.0
2625,2010,PA,SENADOR,PSTU,2,0,2,0.0,1.0
2626,2010,PA,SENADOR,PV,1,0,1,0.0,1.0
2627,2010,PA,SENADOR,PSDB,1,0,1,0.0,1.0
2628,2010,PA,SENADOR,PTB,1,0,1,0.0,1.0
2629,2010,PA,SENADOR,PMDB,2,0,2,0.0,1.0
2630,2010,PA,SENADOR,PSOL,1,1,2,0.5,0.5
2631,2010,PA,SENADOR,PT,1,0,1,0.0,1.0
2632,2010,PA,SENADOR,PSB,0,1,1,1.0,0.0
2633,2014,PA,DEPUTADO ESTADUAL,PP,6,3,9,0.3333333333333333,0.6666666666666666
2634,2014,PA,DEPUTADO ESTADUAL,PSD,10,3,13,0.23076923076923078,0.7692307692307693
2635,2014,PA,DEPUTADO ESTADUAL,PSDB,23,11,34,0.3235294117647059,0.6764705882352942
2636,2014,PA,DEPUTADO ESTADUAL,PT,29,13,42,0.30952380952380953,0.6904761904761905
2637,2014,PA,DEPUTADO ESTADUAL,PSC,38,19,57,0.3333333333333333,0.6666666666666666
2638,2014,PA,DEPUTADO ESTADUAL,PPS,33,15,48,0.3125,0.6875
2639,2014,PA,DEPUTADO ESTADUAL,PV,20,6,26,0.23076923076923078,0.7692307692307693
2640,2014,PA,DEPUTADO ESTADUAL,PRB,17,11,28,0.39285714285714285,0.6071428571428571
2641,2014,PA,DEPUTADO ESTADUAL,PT do B,9,3,12,0.25,0.75
2642,2014,PA,DEPUTADO ESTADUAL,PRP,4,1,5,0.2,0.8
2643,2014,PA,DEPUTADO ESTADUAL,PMN,4,2,6,0.3333333333333333,0.6666666666666666
2644,2014,PA,DEPUTADO ESTADUAL,PDT,36,19,55,0.34545454545454546,0.6545454545454545
2645,2014,PA,DEPUTADO ESTADUAL,PC do B,45,22,67,0.3283582089552239,0.6716417910447762
2646,2014,PA,DEPUTADO ESTADUAL,PSB,20,9,29,0.3103448275862069,0.6896551724137931
2647,2014,PA,DEPUTADO ESTADUAL,PHS,35,9,44,0.20454545454545456,0.7954545454545454
2648,2014,PA,DEPUTADO ESTADUAL,PR,35,22,57,0.38596491228070173,0.6140350877192983
2649,2014,PA,DEPUTADO ESTADUAL,PSL,20,7,27,0.25925925925925924,0.7407407407407407
2650,2014,PA,DEPUTADO ESTADUAL,PPL,7,3,10,0.3,0.7
2651,2014,PA,DEPUTADO ESTADUAL,PEN,15,10,25,0.4,0.6
2652,2014,PA,DEPUTADO ESTADUAL,PMDB,27,12,39,0.3076923076923077,0.6923076923076923
2653,2014,PA,DEPUTADO ESTADUAL,PROS,16,7,23,0.30434782608695654,0.6956521739130435
2654,2014,PA,DEPUTADO ESTADUAL,PTB,8,3,11,0.2727272727272727,0.7272727272727273
2655,2014,PA,DEPUTADO ESTADUAL,PTC,12,7,19,0.3684210526315789,0.631578947368421
2656,2014,PA,DEPUTADO ESTADUAL,PSOL,22,10,32,0.3125,0.6875
2657,2014,PA,DEPUTADO ESTADUAL,PTN,7,5,12,0.4166666666666667,0.5833333333333334
2658,2014,PA,DEPUTADO ESTADUAL,DEM,23,10,33,0.30303030303030304,0.696969696969697
2659,2014,PA,DEPUTADO ESTADUAL,SD,9,0,9,0.0,1.0
2660,2014,PA,DEPUTADO ESTADUAL,PRTB,1,1,2,0.5,0.5
2661,2014,PA,DEPUTADO ESTADUAL,PSDC,3,0,3,0.0,1.0
2662,2014,PA,DEPUTADO ESTADUAL,PCB,1,1,2,0.5,0.5
2663,2014,PA,DEPUTADO ESTADUAL,PSTU,1,0,1,0.0,1.0
2664,2014,PA,DEPUTADO FEDERAL,PMN,5,0,5,0.0,1.0
2665,2014,PA,DEPUTADO FEDERAL,PT,6,2,8,0.25,0.75
2666,2014,PA,DEPUTADO FEDERAL,PRTB,5,3,8,0.375,0.625
2667,2014,PA,DEPUTADO FEDERAL,PSDB,11,9,20,0.45,0.55
2668,2014,PA,DEPUTADO FEDERAL,PTC,2,0,2,0.0,1.0
2669,2014,PA,DEPUTADO FEDERAL,PSOL,17,6,23,0.2608695652173913,0.7391304347826086
2670,2014,PA,DEPUTADO FEDERAL,PV,8,3,11,0.2727272727272727,0.7272727272727273
2671,2014,PA,DEPUTADO FEDERAL,PRP,3,1,4,0.25,0.75
2672,2014,PA,DEPUTADO FEDERAL,PDT,11,5,16,0.3125,0.6875
2673,2014,PA,DEPUTADO FEDERAL,DEM,8,4,12,0.3333333333333333,0.6666666666666666
2674,2014,PA,DEPUTADO FEDERAL,PPS,3,1,4,0.25,0.75
2675,2014,PA,DEPUTADO FEDERAL,PHS,5,2,7,0.2857142857142857,0.7142857142857143
2676,2014,PA,DEPUTADO FEDERAL,PMDB,8,4,12,0.3333333333333333,0.6666666666666666
2677,2014,PA,DEPUTADO FEDERAL,PSB,4,0,4,0.0,1.0
2678,2014,PA,DEPUTADO FEDERAL,SD,8,0,8,0.0,1.0
2679,2014,PA,DEPUTADO FEDERAL,PSTU,1,4,5,0.8,0.2
2680,2014,PA,DEPUTADO FEDERAL,PRB,2,5,7,0.7142857142857143,0.2857142857142857
2681,2014,PA,DEPUTADO FEDERAL,PTB,2,0,2,0.0,1.0
2682,2014,PA,DEPUTADO FEDERAL,PEN,6,6,12,0.5,0.5
2683,2014,PA,DEPUTADO FEDERAL,PR,2,2,4,0.5,0.5
2684,2014,PA,DEPUTADO FEDERAL,PTN,10,6,16,0.375,0.625
2685,2014,PA,DEPUTADO FEDERAL,PSL,4,2,6,0.3333333333333333,0.6666666666666666
2686,2014,PA,DEPUTADO FEDERAL,PSD,3,1,4,0.25,0.75
2687,2014,PA,DEPUTADO FEDERAL,PCB,1,1,2,0.5,0.5
2688,2014,PA,DEPUTADO FEDERAL,PPL,3,1,4,0.25,0.75
2689,2014,PA,DEPUTADO FEDERAL,PP,1,1,2,0.5,0.5
2690,2014,PA,DEPUTADO FEDERAL,PC do B,1,0,1,0.0,1.0
2691,2014,PA,DEPUTADO FEDERAL,PSC,1,1,2,0.5,0.5
2692,2014,PA,DEPUTADO FEDERAL,PROS,2,1,3,0.3333333333333333,0.6666666666666666
2693,2014,PA,DEPUTADO FEDERAL,PT do B,1,0,1,0.0,1.0
2694,2014,PA,SENADOR,PSTU,0,1,1,1.0,0.0
2695,2014,PA,SENADOR,PTB,1,0,1,0.0,1.0
2696,2014,PA,SENADOR,PV,1,0,1,0.0,1.0
2697,2014,PA,SENADOR,PCB,1,0,1,0.0,1.0
2698,2014,PA,SENADOR,PSD,1,0,1,0.0,1.0
2699,2014,PA,SENADOR,PSDB,1,0,1,0.0,1.0
2700,2014,PA,SENADOR,SD,0,1,1,1.0,0.0
2701,2014,PA,SENADOR,PT,1,0,1,0.0,1.0
2702,2014,PA,SENADOR,PSOL,1,0,1,0.0,1.0
2703,2014,PA,SENADOR,PP,1,0,1,0.0,1.0
2704,2014,PA,SENADOR,PRTB,1,0,1,0.0,1.0
2705,2018,PA,DEPUTADO ESTADUAL,PRB,37,12,49,0.24489795918367346,0.7551020408163265
2706,2018,PA,DEPUTADO ESTADUAL,PC do B,33,15,48,0.3125,0.6875
2707,2018,PA,DEPUTADO ESTADUAL,PRP,9,4,13,0.3076923076923077,0.6923076923076923
2708,2018,PA,DEPUTADO ESTADUAL,PTB,8,5,13,0.38461538461538464,0.6153846153846154
2709,2018,PA,DEPUTADO ESTADUAL,PV,11,6,17,0.35294117647058826,0.6470588235294118
2710,2018,PA,DEPUTADO ESTADUAL,PMN,13,5,18,0.2777777777777778,0.7222222222222222
2711,2018,PA,DEPUTADO ESTADUAL,SOLIDARIEDADE,20,10,30,0.3333333333333333,0.6666666666666666
2712,2018,PA,DEPUTADO ESTADUAL,PT,15,8,23,0.34782608695652173,0.6521739130434783
2713,2018,PA,DEPUTADO ESTADUAL,PSDB,10,6,16,0.375,0.625
2714,2018,PA,DEPUTADO ESTADUAL,PSOL,20,9,29,0.3103448275862069,0.6896551724137931
2715,2018,PA,DEPUTADO ESTADUAL,PSC,36,16,52,0.3076923076923077,0.6923076923076923
2716,2018,PA,DEPUTADO ESTADUAL,MDB,24,13,37,0.35135135135135137,0.6486486486486487
2717,2018,PA,DEPUTADO ESTADUAL,PRTB,9,4,13,0.3076923076923077,0.6923076923076923
2718,2018,PA,DEPUTADO ESTADUAL,PP,17,7,24,0.2916666666666667,0.7083333333333334
2719,2018,PA,DEPUTADO ESTADUAL,DEM,8,3,11,0.2727272727272727,0.7272727272727273
2720,2018,PA,DEPUTADO ESTADUAL,PSD,10,4,14,0.2857142857142857,0.7142857142857143
2721,2018,PA,DEPUTADO ESTADUAL,PHS,26,15,41,0.36585365853658536,0.6341463414634146
2722,2018,PA,DEPUTADO ESTADUAL,PPL,9,4,13,0.3076923076923077,0.6923076923076923
2723,2018,PA,DEPUTADO ESTADUAL,PPS,22,10,32,0.3125,0.6875
2724,2018,PA,DEPUTADO ESTADUAL,DC,4,1,5,0.2,0.8
2725,2018,PA,DEPUTADO ESTADUAL,PR,18,14,32,0.4375,0.5625
2726,2018,PA,DEPUTADO ESTADUAL,AVANTE,9,2,11,0.18181818181818182,0.8181818181818182
2727,2018,PA,DEPUTADO ESTADUAL,PATRI,12,6,18,0.3333333333333333,0.6666666666666666
2728,2018,PA,DEPUTADO ESTADUAL,PSB,11,8,19,0.42105263157894735,0.5789473684210527
2729,2018,PA,DEPUTADO ESTADUAL,PSL,16,6,22,0.2727272727272727,0.7272727272727273
2730,2018,PA,DEPUTADO ESTADUAL,PDT,15,6,21,0.2857142857142857,0.7142857142857143
2731,2018,PA,DEPUTADO ESTADUAL,PMB,6,7,13,0.5384615384615384,0.46153846153846156
2732,2018,PA,DEPUTADO ESTADUAL,REDE,9,3,12,0.25,0.75
2733,2018,PA,DEPUTADO ESTADUAL,PODE,8,5,13,0.38461538461538464,0.6153846153846154
2734,2018,PA,DEPUTADO ESTADUAL,PTC,11,4,15,0.26666666666666666,0.7333333333333333
2735,2018,PA,DEPUTADO ESTADUAL,PROS,3,4,7,0.5714285714285714,0.42857142857142855
2736,2018,PA,DEPUTADO ESTADUAL,PSTU,1,1,2,0.5,0.5
2737,2018,PA,DEPUTADO FEDERAL,PSD,3,1,4,0.25,0.75
2738,2018,PA,DEPUTADO FEDERAL,PSL,2,0,2,0.0,1.0
2739,2018,PA,DEPUTADO FEDERAL,PT,5,2,7,0.2857142857142857,0.7142857142857143
2740,2018,PA,DEPUTADO FEDERAL,PATRI,8,8,16,0.5,0.5
2741,2018,PA,DEPUTADO FEDERAL,PSDB,4,2,6,0.3333333333333333,0.6666666666666666
2742,2018,PA,DEPUTADO FEDERAL,REDE,4,1,5,0.2,0.8
2743,2018,PA,DEPUTADO FEDERAL,PSOL,12,6,18,0.3333333333333333,0.6666666666666666
2744,2018,PA,DEPUTADO FEDERAL,PRTB,4,2,6,0.3333333333333333,0.6666666666666666
2745,2018,PA,DEPUTADO FEDERAL,PMN,3,1,4,0.25,0.75
2746,2018,PA,DEPUTADO FEDERAL,SOLIDARIEDADE,2,1,3,0.3333333333333333,0.6666666666666666
2747,2018,PA,DEPUTADO FEDERAL,PTC,7,0,7,0.0,1.0
2748,2018,PA,DEPUTADO FEDERAL,PPS,2,0,2,0.0,1.0
2749,2018,PA,DEPUTADO FEDERAL,PRP,8,2,10,0.2,0.8
2750,2018,PA,DEPUTADO FEDERAL,AVANTE,2,0,2,0.0,1.0
2751,2018,PA,DEPUTADO FEDERAL,PV,3,3,6,0.5,0.5
2752,2018,PA,DEPUTADO FEDERAL,PHS,4,2,6,0.3333333333333333,0.6666666666666666
2753,2018,PA,DEPUTADO FEDERAL,MDB,3,3,6,0.5,0.5
2754,2018,PA,DEPUTADO FEDERAL,PODE,1,0,1,0.0,1.0
2755,2018,PA,DEPUTADO FEDERAL,DEM,3,2,5,0.4,0.6
2756,2018,PA,DEPUTADO FEDERAL,PDT,2,2,4,0.5,0.5
2757,2018,PA,DEPUTADO FEDERAL,PPL,5,2,7,0.2857142857142857,0.7142857142857143
2758,2018,PA,DEPUTADO FEDERAL,PMB,0,1,1,1.0,0.0
2759,2018,PA,DEPUTADO FEDERAL,PTB,2,0,2,0.0,1.0
2760,2018,PA,DEPUTADO FEDERAL,PSC,1,1,2,0.5,0.5
2761,2018,PA,DEPUTADO FEDERAL,PC do B,0,1,1,1.0,0.0
2762,2018,PA,DEPUTADO FEDERAL,PCB,1,0,1,0.0,1.0
2763,2018,PA,DEPUTADO FEDERAL,PP,1,0,1,0.0,1.0
2764,2018,PA,DEPUTADO FEDERAL,PRB,1,0,1,0.0,1.0
2765,2018,PA,DEPUTADO FEDERAL,PSB,1,0,1,0.0,1.0
2766,2018,PA,DEPUTADO FEDERAL,PR,1,0,1,0.0,1.0
2767,2018,PA,DEPUTADO FEDERAL,DC,1,0,1,0.0,1.0
2768,2018,PA,DEPUTADO FEDERAL,PROS,2,0,2,0.0,1.0
2769,2018,PA,SENADOR,PSTU,0,1,1,1.0,0.0
2770,2018,PA,SENADOR,PSB,2,0,2,0.0,1.0
2771,2018,PA,SENADOR,PPL,1,0,1,0.0,1.0
2772,2018,PA,SENADOR,PRB,1,0,1,0.0,1.0
2773,2018,PA,SENADOR,PC do B,1,0,1,0.0,1.0
2774,2018,PA,SENADOR,PSOL,0,1,1,1.0,0.0
2775,2018,PA,SENADOR,PSDB,1,0,1,0.0,1.0
2776,2018,PA,SENADOR,PDT,1,0,1,0.0,1.0
2777,2018,PA,SENADOR,PRP,1,0,1,0.0,1.0
2778,2018,PA,SENADOR,PR,1,0,1,0.0,1.0
2779,2018,PA,SENADOR,PTC,1,0,1,0.0,1.0
2780,2018,PA,SENADOR,PT,1,0,1,0.0,1.0
2781,2018,PA,SENADOR,PP,1,0,1,0.0,1.0
2782,2018,PA,SENADOR,PSC,1,0,1,0.0,1.0
2783,2018,PA,SENADOR,SOLIDARIEDADE,1,0,1,0.0,1.0
2784,2018,PA,SENADOR,MDB,1,0,1,0.0,1.0
2785,2018,PA,SENADOR,PV,1,0,1,0.0,1.0
2786,2010,PB,DEPUTADO ESTADUAL,DEM,9,4,13,0.3076923076923077,0.6923076923076923
2787,2010,PB,DEPUTADO ESTADUAL,PMDB,18,11,29,0.3793103448275862,0.6206896551724138
2788,2010,PB,DEPUTADO ESTADUAL,PHS,8,0,8,0.0,1.0
2789,2010,PB,DEPUTADO ESTADUAL,PSL,11,5,16,0.3125,0.6875
2790,2010,PB,DEPUTADO ESTADUAL,PRP,10,4,14,0.2857142857142857,0.7142857142857143
2791,2010,PB,DEPUTADO ESTADUAL,PSB,11,7,18,0.3888888888888889,0.6111111111111112
2792,2010,PB,DEPUTADO ESTADUAL,PRTB,7,1,8,0.125,0.875
2793,2010,PB,DEPUTADO ESTADUAL,PSDC,8,1,9,0.1111111111111111,0.8888888888888888
2794,2010,PB,DEPUTADO ESTADUAL,PC do B,4,0,4,0.0,1.0
2795,2010,PB,DEPUTADO ESTADUAL,PV,6,1,7,0.14285714285714285,0.8571428571428571
2796,2010,PB,DEPUTADO ESTADUAL,PSOL,10,1,11,0.09090909090909091,0.9090909090909091
2797,2010,PB,DEPUTADO ESTADUAL,PPS,13,7,20,0.35,0.65
2798,2010,PB,DEPUTADO ESTADUAL,PT,24,10,34,0.29411764705882354,0.7058823529411765
2799,2010,PB,DEPUTADO ESTADUAL,PCO,2,0,2,0.0,1.0
2800,2010,PB,DEPUTADO ESTADUAL,PMN,7,1,8,0.125,0.875
2801,2010,PB,DEPUTADO ESTADUAL,PCB,9,0,9,0.0,1.0
2802,2010,PB,DEPUTADO ESTADUAL,PP,9,2,11,0.18181818181818182,0.8181818181818182
2803,2010,PB,DEPUTADO ESTADUAL,PSDB,16,1,17,0.058823529411764705,0.9411764705882353
2804,2010,PB,DEPUTADO ESTADUAL,PT do B,11,5,16,0.3125,0.6875
2805,2010,PB,DEPUTADO ESTADUAL,PTN,4,3,7,0.42857142857142855,0.5714285714285714
2806,2010,PB,DEPUTADO ESTADUAL,PSC,10,1,11,0.09090909090909091,0.9090909090909091
2807,2010,PB,DEPUTADO ESTADUAL,PR,7,0,7,0.0,1.0
2808,2010,PB,DEPUTADO ESTADUAL,PTB,6,2,8,0.25,0.75
2809,2010,PB,DEPUTADO ESTADUAL,PRB,7,3,10,0.3,0.7
2810,2010,PB,DEPUTADO ESTADUAL,PTC,15,3,18,0.16666666666666666,0.8333333333333334
2811,2010,PB,DEPUTADO ESTADUAL,PDT,3,0,3,0.0,1.0
2812,2010,PB,DEPUTADO FEDERAL,PMDB,9,3,12,0.25,0.75
2813,2010,PB,DEPUTADO FEDERAL,PT,8,4,12,0.3333333333333333,0.6666666666666666
2814,2010,PB,DEPUTADO FEDERAL,PP,3,0,3,0.0,1.0
2815,2010,PB,DEPUTADO FEDERAL,PSL,2,1,3,0.3333333333333333,0.6666666666666666
2816,2010,PB,DEPUTADO FEDERAL,PR,3,1,4,0.25,0.75
2817,2010,PB,DEPUTADO FEDERAL,PHS,1,1,2,0.5,0.5
2818,2010,PB,DEPUTADO FEDERAL,PSDB,7,1,8,0.125,0.875
2819,2010,PB,DEPUTADO FEDERAL,PTB,2,0,2,0.0,1.0
2820,2010,PB,DEPUTADO FEDERAL,DEM,3,1,4,0.25,0.75
2821,2010,PB,DEPUTADO FEDERAL,PSB,5,4,9,0.4444444444444444,0.5555555555555556
2822,2010,PB,DEPUTADO FEDERAL,PSC,3,0,3,0.0,1.0
2823,2010,PB,DEPUTADO FEDERAL,PCO,2,0,2,0.0,1.0
2824,2010,PB,DEPUTADO FEDERAL,PSTU,1,0,1,0.0,1.0
2825,2010,PB,DEPUTADO FEDERAL,PDT,4,0,4,0.0,1.0
2826,2010,PB,DEPUTADO FEDERAL,PMN,2,2,4,0.5,0.5
2827,2010,PB,DEPUTADO FEDERAL,PSOL,6,1,7,0.14285714285714285,0.8571428571428571
2828,2010,PB,DEPUTADO FEDERAL,PRB,3,0,3,0.0,1.0
2829,2010,PB,DEPUTADO FEDERAL,PC do B,3,1,4,0.25,0.75
2830,2010,PB,DEPUTADO FEDERAL,PRP,2,0,2,0.0,1.0
2831,2010,PB,DEPUTADO FEDERAL,PV,2,0,2,0.0,1.0
2832,2010,PB,DEPUTADO FEDERAL,PTN,1,0,1,0.0,1.0
2833,2010,PB,DEPUTADO FEDERAL,PCB,2,0,2,0.0,1.0
2834,2010,PB,DEPUTADO FEDERAL,PRTB,1,0,1,0.0,1.0
2835,2010,PB,DEPUTADO FEDERAL,PT do B,1,0,1,0.0,1.0
2836,2010,PB,DEPUTADO FEDERAL,PPS,1,0,1,0.0,1.0
2837,2010,PB,SENADOR,PSDB,1,0,1,0.0,1.0
2838,2010,PB,SENADOR,PSOL,2,0,2,0.0,1.0
2839,2010,PB,SENADOR,DEM,1,0,1,0.0,1.0
2840,2010,PB,SENADOR,PMDB,2,0,2,0.0,1.0
2841,2010,PB,SENADOR,PCO,0,1,1,1.0,0.0
2842,2010,PB,SENADOR,PCB,1,0,1,0.0,1.0
2843,2014,PB,DEPUTADO ESTADUAL,PMDB,10,4,14,0.2857142857142857,0.7142857142857143
2844,2014,PB,DEPUTADO ESTADUAL,PRP,6,4,10,0.4,0.6
2845,2014,PB,DEPUTADO ESTADUAL,PT,11,5,16,0.3125,0.6875
2846,2014,PB,DEPUTADO ESTADUAL,PTN,8,1,9,0.1111111111111111,0.8888888888888888
2847,2014,PB,DEPUTADO ESTADUAL,PMN,17,5,22,0.22727272727272727,0.7727272727272727
2848,2014,PB,DEPUTADO ESTADUAL,PPS,10,1,11,0.09090909090909091,0.9090909090909091
2849,2014,PB,DEPUTADO ESTADUAL,PT do B,20,16,36,0.4444444444444444,0.5555555555555556
2850,2014,PB,DEPUTADO ESTADUAL,PDT,4,0,4,0.0,1.0
2851,2014,PB,DEPUTADO ESTADUAL,PV,4,3,7,0.42857142857142855,0.5714285714285714
2852,2014,PB,DEPUTADO ESTADUAL,PSOL,10,6,16,0.375,0.625
2853,2014,PB,DEPUTADO ESTADUAL,PSD,13,8,21,0.38095238095238093,0.6190476190476191
2854,2014,PB,DEPUTADO ESTADUAL,PC do B,11,6,17,0.35294117647058826,0.6470588235294118
2855,2014,PB,DEPUTADO ESTADUAL,PTB,10,0,10,0.0,1.0
2856,2014,PB,DEPUTADO ESTADUAL,PP,8,4,12,0.3333333333333333,0.6666666666666666
2857,2014,PB,DEPUTADO ESTADUAL,PR,3,1,4,0.25,0.75
2858,2014,PB,DEPUTADO ESTADUAL,PSDB,16,14,30,0.4666666666666667,0.5333333333333333
2859,2014,PB,DEPUTADO ESTADUAL,PHS,11,2,13,0.15384615384615385,0.8461538461538461
2860,2014,PB,DEPUTADO ESTADUAL,PROS,22,12,34,0.35294117647058826,0.6470588235294118
2861,2014,PB,DEPUTADO ESTADUAL,PTC,4,2,6,0.3333333333333333,0.6666666666666666
2862,2014,PB,DEPUTADO ESTADUAL,PEN,7,5,12,0.4166666666666667,0.5833333333333334
2863,2014,PB,DEPUTADO ESTADUAL,PSL,12,8,20,0.4,0.6
2864,2014,PB,DEPUTADO ESTADUAL,PPL,5,2,7,0.2857142857142857,0.7142857142857143
2865,2014,PB,DEPUTADO ESTADUAL,PSC,15,5,20,0.25,0.75
2866,2014,PB,DEPUTADO ESTADUAL,PSB,15,10,25,0.4,0.6
2867,2014,PB,DEPUTADO ESTADUAL,PRTB,7,1,8,0.125,0.875
2868,2014,PB,DEPUTADO ESTADUAL,PRB,10,9,19,0.47368421052631576,0.5263157894736842
2869,2014,PB,DEPUTADO ESTADUAL,PSTU,1,1,2,0.5,0.5
2870,2014,PB,DEPUTADO ESTADUAL,PSDC,7,2,9,0.2222222222222222,0.7777777777777778
2871,2014,PB,DEPUTADO ESTADUAL,DEM,6,4,10,0.4,0.6
2872,2014,PB,DEPUTADO ESTADUAL,SD,1,0,1,0.0,1.0
2873,2014,PB,DEPUTADO ESTADUAL,PCO,0,1,1,1.0,0.0
2874,2014,PB,DEPUTADO FEDERAL,PSDB,3,2,5,0.4,0.6
2875,2014,PB,DEPUTADO FEDERAL,PMDB,5,3,8,0.375,0.625
2876,2014,PB,DEPUTADO FEDERAL,PRTB,5,1,6,0.16666666666666666,0.8333333333333334
2877,2014,PB,DEPUTADO FEDERAL,PDT,3,0,3,0.0,1.0
2878,2014,PB,DEPUTADO FEDERAL,PSD,2,2,4,0.5,0.5
2879,2014,PB,DEPUTADO FEDERAL,DEM,2,1,3,0.3333333333333333,0.6666666666666666
2880,2014,PB,DEPUTADO FEDERAL,PHS,1,1,2,0.5,0.5
2881,2014,PB,DEPUTADO FEDERAL,PRB,3,0,3,0.0,1.0
2882,2014,PB,DEPUTADO FEDERAL,PTN,2,0,2,0.0,1.0
2883,2014,PB,DEPUTADO FEDERAL,PV,4,1,5,0.2,0.8
2884,2014,PB,DEPUTADO FEDERAL,PSL,2,1,3,0.3333333333333333,0.6666666666666666
2885,2014,PB,DEPUTADO FEDERAL,PSOL,5,3,8,0.375,0.625
2886,2014,PB,DEPUTADO FEDERAL,PSB,6,0,6,0.0,1.0
2887,2014,PB,DEPUTADO FEDERAL,PTB,4,5,9,0.5555555555555556,0.4444444444444444
2888,2014,PB,DEPUTADO FEDERAL,PR,1,1,2,0.5,0.5
2889,2014,PB,DEPUTADO FEDERAL,PP,3,2,5,0.4,0.6
2890,2014,PB,DEPUTADO FEDERAL,PMN,5,1,6,0.16666666666666666,0.8333333333333334
2891,2014,PB,DEPUTADO FEDERAL,PROS,3,3,6,0.5,0.5
2892,2014,PB,DEPUTADO FEDERAL,PRP,3,2,5,0.4,0.6
2893,2014,PB,DEPUTADO FEDERAL,SD,1,0,1,0.0,1.0
2894,2014,PB,DEPUTADO FEDERAL,PT,7,2,9,0.2222222222222222,0.7777777777777778
2895,2014,PB,DEPUTADO FEDERAL,PCO,1,0,1,0.0,1.0
2896,2014,PB,DEPUTADO FEDERAL,PC do B,1,0,1,0.0,1.0
2897,2014,PB,DEPUTADO FEDERAL,PPL,3,1,4,0.25,0.75
2898,2014,PB,DEPUTADO FEDERAL,PTC,1,0,1,0.0,1.0
2899,2014,PB,DEPUTADO FEDERAL,PSC,1,0,1,0.0,1.0
2900,2014,PB,DEPUTADO FEDERAL,PSDC,1,0,1,0.0,1.0
2901,2014,PB,DEPUTADO FEDERAL,PT do B,2,4,6,0.6666666666666666,0.3333333333333333
2902,2014,PB,DEPUTADO FEDERAL,PPS,1,0,1,0.0,1.0
2903,2014,PB,SENADOR,PT,1,0,1,0.0,1.0
2904,2014,PB,SENADOR,PROS,0,1,1,1.0,0.0
2905,2014,PB,SENADOR,PTC,1,0,1,0.0,1.0
2906,2014,PB,SENADOR,PCO,1,0,1,0.0,1.0
2907,2014,PB,SENADOR,PTB,1,0,1,0.0,1.0
2908,2014,PB,SENADOR,PSTU,0,1,1,1.0,0.0
2909,2014,PB,SENADOR,PSOL,1,0,1,0.0,1.0
2910,2014,PB,SENADOR,PMDB,1,0,1,0.0,1.0
2911,2018,PB,DEPUTADO ESTADUAL,PT,18,7,25,0.28,0.72
2912,2018,PB,DEPUTADO ESTADUAL,PPS,16,8,24,0.3333333333333333,0.6666666666666666
2913,2018,PB,DEPUTADO ESTADUAL,PATRI,25,11,36,0.3055555555555556,0.6944444444444444
2914,2018,PB,DEPUTADO ESTADUAL,PSDB,10,4,14,0.2857142857142857,0.7142857142857143
2915,2018,PB,DEPUTADO ESTADUAL,PSD,9,5,14,0.35714285714285715,0.6428571428571429
2916,2018,PB,DEPUTADO ESTADUAL,PSOL,6,4,10,0.4,0.6
2917,2018,PB,DEPUTADO ESTADUAL,PC do B,13,6,19,0.3157894736842105,0.6842105263157895
2918,2018,PB,DEPUTADO ESTADUAL,PRB,4,3,7,0.42857142857142855,0.5714285714285714
2919,2018,PB,DEPUTADO ESTADUAL,AVANTE,20,8,28,0.2857142857142857,0.7142857142857143
2920,2018,PB,DEPUTADO ESTADUAL,DEM,9,3,12,0.25,0.75
2921,2018,PB,DEPUTADO ESTADUAL,MDB,24,13,37,0.35135135135135137,0.6486486486486487
2922,2018,PB,DEPUTADO ESTADUAL,PRTB,17,9,26,0.34615384615384615,0.6538461538461539
2923,2018,PB,DEPUTADO ESTADUAL,PROS,12,7,19,0.3684210526315789,0.631578947368421
2924,2018,PB,DEPUTADO ESTADUAL,PTB,6,1,7,0.14285714285714285,0.8571428571428571
2925,2018,PB,DEPUTADO ESTADUAL,PMN,8,2,10,0.2,0.8
2926,2018,PB,DEPUTADO ESTADUAL,PP,3,2,5,0.4,0.6
2927,2018,PB,DEPUTADO ESTADUAL,PR,5,2,7,0.2857142857142857,0.7142857142857143
2928,2018,PB,DEPUTADO ESTADUAL,PSL,15,7,22,0.3181818181818182,0.6818181818181818
2929,2018,PB,DEPUTADO ESTADUAL,PODE,7,2,9,0.2222222222222222,0.7777777777777778
2930,2018,PB,DEPUTADO ESTADUAL,PDT,9,4,13,0.3076923076923077,0.6923076923076923
2931,2018,PB,DEPUTADO ESTADUAL,PSB,13,5,18,0.2777777777777778,0.7222222222222222
2932,2018,PB,DEPUTADO ESTADUAL,PV,5,3,8,0.375,0.625
2933,2018,PB,DEPUTADO ESTADUAL,PSC,7,3,10,0.3,0.7
2934,2018,PB,DEPUTADO ESTADUAL,REDE,12,6,18,0.3333333333333333,0.6666666666666666
2935,2018,PB,DEPUTADO ESTADUAL,PTC,8,2,10,0.2,0.8
2936,2018,PB,DEPUTADO ESTADUAL,SOLIDARIEDADE,2,3,5,0.6,0.4
2937,2018,PB,DEPUTADO ESTADUAL,PRP,2,1,3,0.3333333333333333,0.6666666666666666
2938,2018,PB,DEPUTADO ESTADUAL,DC,4,0,4,0.0,1.0
2939,2018,PB,DEPUTADO ESTADUAL,PHS,1,0,1,0.0,1.0
2940,2018,PB,DEPUTADO FEDERAL,PPS,3,1,4,0.25,0.75
2941,2018,PB,DEPUTADO FEDERAL,PSL,11,4,15,0.26666666666666666,0.7333333333333333
2942,2018,PB,DEPUTADO FEDERAL,PV,4,2,6,0.3333333333333333,0.6666666666666666
2943,2018,PB,DEPUTADO FEDERAL,PP,6,2,8,0.25,0.75
2944,2018,PB,DEPUTADO FEDERAL,PSB,3,2,5,0.4,0.6
2945,2018,PB,DEPUTADO FEDERAL,PATRI,9,1,10,0.1,0.9
2946,2018,PB,DEPUTADO FEDERAL,PTC,3,4,7,0.5714285714285714,0.42857142857142855
2947,2018,PB,DEPUTADO FEDERAL,AVANTE,9,4,13,0.3076923076923077,0.6923076923076923
2948,2018,PB,DEPUTADO FEDERAL,PC do B,2,2,4,0.5,0.5
2949,2018,PB,DEPUTADO FEDERAL,PMN,1,1,2,0.5,0.5
2950,2018,PB,DEPUTADO FEDERAL,MDB,5,5,10,0.5,0.5
2951,2018,PB,DEPUTADO FEDERAL,PRP,3,2,5,0.4,0.6
2952,2018,PB,DEPUTADO FEDERAL,PSDB,5,3,8,0.375,0.625
2953,2018,PB,DEPUTADO FEDERAL,PR,2,1,3,0.3333333333333333,0.6666666666666666
2954,2018,PB,DEPUTADO FEDERAL,PSOL,4,4,8,0.5,0.5
2955,2018,PB,DEPUTADO FEDERAL,PRB,3,0,3,0.0,1.0
2956,2018,PB,DEPUTADO FEDERAL,REDE,3,2,5,0.4,0.6
2957,2018,PB,DEPUTADO FEDERAL,PHS,5,1,6,0.16666666666666666,0.8333333333333334
2958,2018,PB,DEPUTADO FEDERAL,PTB,2,1,3,0.3333333333333333,0.6666666666666666
2959,2018,PB,DEPUTADO FEDERAL,PSC,2,1,3,0.3333333333333333,0.6666666666666666
2960,2018,PB,DEPUTADO FEDERAL,PT,3,1,4,0.25,0.75
2961,2018,PB,DEPUTADO FEDERAL,PSD,4,1,5,0.2,0.8
2962,2018,PB,DEPUTADO FEDERAL,DEM,1,1,2,0.5,0.5
2963,2018,PB,DEPUTADO FEDERAL,DC,2,0,2,0.0,1.0
2964,2018,PB,DEPUTADO FEDERAL,PRTB,3,4,7,0.5714285714285714,0.42857142857142855
2965,2018,PB,DEPUTADO FEDERAL,PROS,3,0,3,0.0,1.0
2966,2018,PB,DEPUTADO FEDERAL,PODE,2,1,3,0.3333333333333333,0.6666666666666666
2967,2018,PB,DEPUTADO FEDERAL,NOVO,1,1,2,0.5,0.5
2968,2018,PB,DEPUTADO FEDERAL,SOLIDARIEDADE,1,0,1,0.0,1.0
2969,2018,PB,DEPUTADO FEDERAL,PDT,1,0,1,0.0,1.0
2970,2018,PB,DEPUTADO FEDERAL,PPL,1,0,1,0.0,1.0
2971,2018,PB,SENADOR,PSB,1,0,1,0.0,1.0
2972,2018,PB,SENADOR,PT,1,0,1,0.0,1.0
2973,2018,PB,SENADOR,PP,0,1,1,1.0,0.0
2974,2018,PB,SENADOR,PSOL,2,0,2,0.0,1.0
2975,2018,PB,SENADOR,PSDB,1,0,1,0.0,1.0
2976,2018,PB,SENADOR,MDB,1,0,1,0.0,1.0
2977,2010,PR,DEPUTADO ESTADUAL,PR,7,3,10,0.3,0.7
2978,2010,PR,DEPUTADO ESTADUAL,PDT,16,5,21,0.23809523809523808,0.7619047619047619
2979,2010,PR,DEPUTADO ESTADUAL,PSOL,17,4,21,0.19047619047619047,0.8095238095238095
2980,2010,PR,DEPUTADO ESTADUAL,PSC,48,7,55,0.12727272727272726,0.8727272727272727
2981,2010,PR,DEPUTADO ESTADUAL,PT,17,8,25,0.32,0.68
2982,2010,PR,DEPUTADO ESTADUAL,PP,16,6,22,0.2727272727272727,0.7272727272727273
2983,2010,PR,DEPUTADO ESTADUAL,PSDC,10,4,14,0.2857142857142857,0.7142857142857143
2984,2010,PR,DEPUTADO ESTADUAL,PMDB,28,11,39,0.28205128205128205,0.717948717948718
2985,2010,PR,DEPUTADO ESTADUAL,PMN,34,22,56,0.39285714285714285,0.6071428571428571
2986,2010,PR,DEPUTADO ESTADUAL,PSL,23,10,33,0.30303030303030304,0.696969696969697
2987,2010,PR,DEPUTADO ESTADUAL,PTN,7,2,9,0.2222222222222222,0.7777777777777778
2988,2010,PR,DEPUTADO ESTADUAL,PSDB,31,10,41,0.24390243902439024,0.7560975609756098
2989,2010,PR,DEPUTADO ESTADUAL,PPS,44,24,68,0.35294117647058826,0.6470588235294118
2990,2010,PR,DEPUTADO ESTADUAL,PSB,31,4,35,0.11428571428571428,0.8857142857142857
2991,2010,PR,DEPUTADO ESTADUAL,PRB,10,5,15,0.3333333333333333,0.6666666666666666
2992,2010,PR,DEPUTADO ESTADUAL,PHS,9,2,11,0.18181818181818182,0.8181818181818182
2993,2010,PR,DEPUTADO ESTADUAL,PV,56,26,82,0.3170731707317073,0.6829268292682927
2994,2010,PR,DEPUTADO ESTADUAL,DEM,17,3,20,0.15,0.85
2995,2010,PR,DEPUTADO ESTADUAL,PRTB,14,3,17,0.17647058823529413,0.8235294117647058
2996,2010,PR,DEPUTADO ESTADUAL,PT do B,4,0,4,0.0,1.0
2997,2010,PR,DEPUTADO ESTADUAL,PTB,7,0,7,0.0,1.0
2998,2010,PR,DEPUTADO ESTADUAL,PTC,13,1,14,0.07142857142857142,0.9285714285714286
2999,2010,PR,DEPUTADO ESTADUAL,PSTU,2,1,3,0.3333333333333333,0.6666666666666666
3000,2010,PR,DEPUTADO ESTADUAL,PC do B,6,0,6,0.0,1.0
3001,2010,PR,DEPUTADO ESTADUAL,PRP,4,4,8,0.5,0.5
3002,2010,PR,DEPUTADO ESTADUAL,PCB,5,0,5,0.0,1.0
3003,2010,PR,DEPUTADO FEDERAL,DEM,8,0,8,0.0,1.0
3004,2010,PR,DEPUTADO FEDERAL,PMN,21,15,36,0.4166666666666667,0.5833333333333334
3005,2010,PR,DEPUTADO FEDERAL,PTB,13,4,17,0.23529411764705882,0.7647058823529411
3006,2010,PR,DEPUTADO FEDERAL,PMDB,16,5,21,0.23809523809523808,0.7619047619047619
3007,2010,PR,DEPUTADO FEDERAL,PV,33,14,47,0.2978723404255319,0.7021276595744681
3008,2010,PR,DEPUTADO FEDERAL,PT do B,7,1,8,0.125,0.875
3009,2010,PR,DEPUTADO FEDERAL,PSDB,13,2,15,0.13333333333333333,0.8666666666666667
3010,2010,PR,DEPUTADO FEDERAL,PRP,2,5,7,0.7142857142857143,0.2857142857142857
3011,2010,PR,DEPUTADO FEDERAL,PR,4,2,6,0.3333333333333333,0.6666666666666666
3012,2010,PR,DEPUTADO FEDERAL,PPS,8,4,12,0.3333333333333333,0.6666666666666666
3013,2010,PR,DEPUTADO FEDERAL,PHS,11,0,11,0.0,1.0
3014,2010,PR,DEPUTADO FEDERAL,PSB,29,9,38,0.23684210526315788,0.7631578947368421
3015,2010,PR,DEPUTADO FEDERAL,PSL,11,1,12,0.08333333333333333,0.9166666666666666
3016,2010,PR,DEPUTADO FEDERAL,PSOL,12,2,14,0.14285714285714285,0.8571428571428571
3017,2010,PR,DEPUTADO FEDERAL,PDT,7,4,11,0.36363636363636365,0.6363636363636364
3018,2010,PR,DEPUTADO FEDERAL,PT,8,4,12,0.3333333333333333,0.6666666666666666
3019,2010,PR,DEPUTADO FEDERAL,PP,9,1,10,0.1,0.9
3020,2010,PR,DEPUTADO FEDERAL,PSC,20,4,24,0.16666666666666666,0.8333333333333334
3021,2010,PR,DEPUTADO FEDERAL,PRB,6,3,9,0.3333333333333333,0.6666666666666666
3022,2010,PR,DEPUTADO FEDERAL,PTC,5,2,7,0.2857142857142857,0.7142857142857143
3023,2010,PR,DEPUTADO FEDERAL,PC do B,2,0,2,0.0,1.0
3024,2010,PR,DEPUTADO FEDERAL,PRTB,4,0,4,0.0,1.0
3025,2010,PR,DEPUTADO FEDERAL,PSDC,1,0,1,0.0,1.0
3026,2010,PR,DEPUTADO FEDERAL,PSTU,0,1,1,1.0,0.0
3027,2010,PR,DEPUTADO FEDERAL,PTN,2,0,2,0.0,1.0
3028,2010,PR,DEPUTADO FEDERAL,PCB,2,0,2,0.0,1.0
3029,2010,PR,SENADOR,PRTB,2,0,2,0.0,1.0
3030,2010,PR,SENADOR,PSTU,1,0,1,0.0,1.0
3031,2010,PR,SENADOR,PCB,1,0,1,0.0,1.0
3032,2010,PR,SENADOR,PT,0,1,1,1.0,0.0
3033,2010,PR,SENADOR,PSDB,1,0,1,0.0,1.0
3034,2010,PR,SENADOR,PT do B,1,0,1,0.0,1.0
3035,2010,PR,SENADOR,PSOL,2,0,2,0.0,1.0
3036,2010,PR,SENADOR,PP,1,0,1,0.0,1.0
3037,2010,PR,SENADOR,PMDB,1,0,1,0.0,1.0
3038,2010,PR,SENADOR,PV,1,0,1,0.0,1.0
3039,2014,PR,DEPUTADO ESTADUAL,PSDB,24,11,35,0.3142857142857143,0.6857142857142857
3040,2014,PR,DEPUTADO ESTADUAL,DEM,7,3,10,0.3,0.7
3041,2014,PR,DEPUTADO ESTADUAL,PRP,12,7,19,0.3684210526315789,0.631578947368421
3042,2014,PR,DEPUTADO ESTADUAL,PSDC,32,18,50,0.36,0.64
3043,2014,PR,DEPUTADO ESTADUAL,PROS,3,0,3,0.0,1.0
3044,2014,PR,DEPUTADO ESTADUAL,PSL,35,15,50,0.3,0.7
3045,2014,PR,DEPUTADO ESTADUAL,PTB,24,11,35,0.3142857142857143,0.6857142857142857
3046,2014,PR,DEPUTADO ESTADUAL,PP,22,9,31,0.2903225806451613,0.7096774193548387
3047,2014,PR,DEPUTADO ESTADUAL,PV,49,21,70,0.3,0.7
3048,2014,PR,DEPUTADO ESTADUAL,PSTU,3,2,5,0.4,0.6
3049,2014,PR,DEPUTADO ESTADUAL,PMDB,33,18,51,0.35294117647058826,0.6470588235294118
3050,2014,PR,DEPUTADO ESTADUAL,PT,20,11,31,0.3548387096774194,0.6451612903225806
3051,2014,PR,DEPUTADO ESTADUAL,PRB,5,2,7,0.2857142857142857,0.7142857142857143
3052,2014,PR,DEPUTADO ESTADUAL,SD,23,10,33,0.30303030303030304,0.696969696969697
3053,2014,PR,DEPUTADO ESTADUAL,PSC,57,28,85,0.32941176470588235,0.6705882352941176
3054,2014,PR,DEPUTADO ESTADUAL,PEN,25,7,32,0.21875,0.78125
3055,2014,PR,DEPUTADO ESTADUAL,PSD,24,11,35,0.3142857142857143,0.6857142857142857
3056,2014,PR,DEPUTADO ESTADUAL,PPS,34,18,52,0.34615384615384615,0.6538461538461539
3057,2014,PR,DEPUTADO ESTADUAL,PTC,15,8,23,0.34782608695652173,0.6521739130434783
3058,2014,PR,DEPUTADO ESTADUAL,PPL,9,4,13,0.3076923076923077,0.6923076923076923
3059,2014,PR,DEPUTADO ESTADUAL,PC do B,7,3,10,0.3,0.7
3060,2014,PR,DEPUTADO ESTADUAL,PDT,20,6,26,0.23076923076923078,0.7692307692307693
3061,2014,PR,DEPUTADO ESTADUAL,PSOL,16,7,23,0.30434782608695654,0.6956521739130435
3062,2014,PR,DEPUTADO ESTADUAL,PR,10,1,11,0.09090909090909091,0.9090909090909091
3063,2014,PR,DEPUTADO ESTADUAL,PTN,30,14,44,0.3181818181818182,0.6818181818181818
3064,2014,PR,DEPUTADO ESTADUAL,PT do B,9,4,13,0.3076923076923077,0.6923076923076923
3065,2014,PR,DEPUTADO ESTADUAL,PSB,11,7,18,0.3888888888888889,0.6111111111111112
3066,2014,PR,DEPUTADO ESTADUAL,PHS,5,2,7,0.2857142857142857,0.7142857142857143
3067,2014,PR,DEPUTADO ESTADUAL,PMN,13,7,20,0.35,0.65
3068,2014,PR,DEPUTADO ESTADUAL,PCB,1,1,2,0.5,0.5
3069,2014,PR,DEPUTADO ESTADUAL,PRTB,1,1,2,0.5,0.5
3070,2014,PR,DEPUTADO FEDERAL,DEM,4,0,4,0.0,1.0
3071,2014,PR,DEPUTADO FEDERAL,SD,3,2,5,0.4,0.6
3072,2014,PR,DEPUTADO FEDERAL,PSL,2,1,3,0.3333333333333333,0.6666666666666666
3073,2014,PR,DEPUTADO FEDERAL,PSDB,6,2,8,0.25,0.75
3074,2014,PR,DEPUTADO FEDERAL,PR,3,0,3,0.0,1.0
3075,2014,PR,DEPUTADO FEDERAL,PSOL,11,5,16,0.3125,0.6875
3076,2014,PR,DEPUTADO FEDERAL,PSB,27,12,39,0.3076923076923077,0.6923076923076923
3077,2014,PR,DEPUTADO FEDERAL,PRB,4,2,6,0.3333333333333333,0.6666666666666666
3078,2014,PR,DEPUTADO FEDERAL,PDT,15,6,21,0.2857142857142857,0.7142857142857143
3079,2014,PR,DEPUTADO FEDERAL,PMDB,16,9,25,0.36,0.64
3080,2014,PR,DEPUTADO FEDERAL,PMN,4,0,4,0.0,1.0
3081,2014,PR,DEPUTADO FEDERAL,PEN,8,5,13,0.38461538461538464,0.6153846153846154
3082,2014,PR,DEPUTADO FEDERAL,PC do B,4,2,6,0.3333333333333333,0.6666666666666666
3083,2014,PR,DEPUTADO FEDERAL,PSDC,9,8,17,0.47058823529411764,0.5294117647058824
3084,2014,PR,DEPUTADO FEDERAL,PRTB,6,5,11,0.45454545454545453,0.5454545454545454
3085,2014,PR,DEPUTADO FEDERAL,PV,27,12,39,0.3076923076923077,0.6923076923076923
3086,2014,PR,DEPUTADO FEDERAL,PTB,10,3,13,0.23076923076923078,0.7692307692307693
3087,2014,PR,DEPUTADO FEDERAL,PSTU,1,1,2,0.5,0.5
3088,2014,PR,DEPUTADO FEDERAL,PT,14,6,20,0.3,0.7
3089,2014,PR,DEPUTADO FEDERAL,PTC,13,6,19,0.3157894736842105,0.6842105263157895
3090,2014,PR,DEPUTADO FEDERAL,PP,4,2,6,0.3333333333333333,0.6666666666666666
3091,2014,PR,DEPUTADO FEDERAL,PHS,9,2,11,0.18181818181818182,0.8181818181818182
3092,2014,PR,DEPUTADO FEDERAL,PPS,6,2,8,0.25,0.75
3093,2014,PR,DEPUTADO FEDERAL,PRP,2,1,3,0.3333333333333333,0.6666666666666666
3094,2014,PR,DEPUTADO FEDERAL,PSD,8,3,11,0.2727272727272727,0.7272727272727273
3095,2014,PR,DEPUTADO FEDERAL,PSC,10,6,16,0.375,0.625
3096,2014,PR,DEPUTADO FEDERAL,PROS,1,0,1,0.0,1.0
3097,2014,PR,DEPUTADO FEDERAL,PT do B,1,2,3,0.6666666666666666,0.3333333333333333
3098,2014,PR,DEPUTADO FEDERAL,PTN,4,2,6,0.3333333333333333,0.6666666666666666
3099,2014,PR,DEPUTADO FEDERAL,PCB,1,1,2,0.5,0.5
3100,2014,PR,DEPUTADO FEDERAL,PPL,2,1,3,0.3333333333333333,0.6666666666666666
3101,2014,PR,SENADOR,PRP,1,0,1,0.0,1.0
3102,2014,PR,SENADOR,PSDB,1,0,1,0.0,1.0
3103,2014,PR,SENADOR,PSOL,1,0,1,0.0,1.0
3104,2014,PR,SENADOR,PMDB,1,0,1,0.0,1.0
3105,2014,PR,SENADOR,PC do B,1,0,1,0.0,1.0
3106,2014,PR,SENADOR,PTC,1,0,1,0.0,1.0
3107,2014,PR,SENADOR,PRTB,1,0,1,0.0,1.0
3108,2014,PR,SENADOR,PSTU,1,0,1,0.0,1.0
3109,2018,PR,DEPUTADO ESTADUAL,REDE,14,7,21,0.3333333333333333,0.6666666666666666
3110,2018,PR,DEPUTADO ESTADUAL,PODE,28,12,40,0.3,0.7
3111,2018,PR,DEPUTADO ESTADUAL,PPS,32,14,46,0.30434782608695654,0.6956521739130435
3112,2018,PR,DEPUTADO ESTADUAL,PSL,35,15,50,0.3,0.7
3113,2018,PR,DEPUTADO ESTADUAL,DC,6,4,10,0.4,0.6
3114,2018,PR,DEPUTADO ESTADUAL,PV,41,18,59,0.3050847457627119,0.6949152542372882
3115,2018,PR,DEPUTADO ESTADUAL,PROS,30,11,41,0.2682926829268293,0.7317073170731707
3116,2018,PR,DEPUTADO ESTADUAL,PP,17,14,31,0.45161290322580644,0.5483870967741935
3117,2018,PR,DEPUTADO ESTADUAL,PSD,26,9,35,0.2571428571428571,0.7428571428571429
3118,2018,PR,DEPUTADO ESTADUAL,PPL,10,3,13,0.23076923076923078,0.7692307692307693
3119,2018,PR,DEPUTADO ESTADUAL,PDT,16,7,23,0.30434782608695654,0.6956521739130435
3120,2018,PR,DEPUTADO ESTADUAL,PRB,17,15,32,0.46875,0.53125
3121,2018,PR,DEPUTADO ESTADUAL,PRP,19,8,27,0.2962962962962963,0.7037037037037037
3122,2018,PR,DEPUTADO ESTADUAL,MDB,20,9,29,0.3103448275862069,0.6896551724137931
3123,2018,PR,DEPUTADO ESTADUAL,PT,21,12,33,0.36363636363636365,0.6363636363636364
3124,2018,PR,DEPUTADO ESTADUAL,PMN,21,9,30,0.3,0.7
3125,2018,PR,DEPUTADO ESTADUAL,PRTB,37,16,53,0.3018867924528302,0.6981132075471698
3126,2018,PR,DEPUTADO ESTADUAL,PSC,25,13,38,0.34210526315789475,0.6578947368421053
3127,2018,PR,DEPUTADO ESTADUAL,PSDB,13,4,17,0.23529411764705882,0.7647058823529411
3128,2018,PR,DEPUTADO ESTADUAL,PATRI,15,5,20,0.25,0.75
3129,2018,PR,DEPUTADO ESTADUAL,PSB,12,5,17,0.29411764705882354,0.7058823529411765
3130,2018,PR,DEPUTADO ESTADUAL,PTB,5,0,5,0.0,1.0
3131,2018,PR,DEPUTADO ESTADUAL,DEM,8,2,10,0.2,0.8
3132,2018,PR,DEPUTADO ESTADUAL,PSOL,15,7,22,0.3181818181818182,0.6818181818181818
3133,2018,PR,DEPUTADO ESTADUAL,PHS,7,2,9,0.2222222222222222,0.7777777777777778
3134,2018,PR,DEPUTADO ESTADUAL,PMB,4,5,9,0.5555555555555556,0.4444444444444444
3135,2018,PR,DEPUTADO ESTADUAL,AVANTE,8,3,11,0.2727272727272727,0.7272727272727273
3136,2018,PR,DEPUTADO ESTADUAL,PCO,2,0,2,0.0,1.0
3137,2018,PR,DEPUTADO ESTADUAL,PR,12,0,12,0.0,1.0
3138,2018,PR,DEPUTADO ESTADUAL,PTC,8,3,11,0.2727272727272727,0.7272727272727273
3139,2018,PR,DEPUTADO ESTADUAL,SOLIDARIEDADE,3,2,5,0.4,0.6
3140,2018,PR,DEPUTADO ESTADUAL,PC do B,1,1,2,0.5,0.5
3141,2018,PR,DEPUTADO FEDERAL,PV,28,13,41,0.3170731707317073,0.6829268292682927
3142,2018,PR,DEPUTADO FEDERAL,PSB,7,3,10,0.3,0.7
3143,2018,PR,DEPUTADO FEDERAL,PSOL,21,9,30,0.3,0.7
3144,2018,PR,DEPUTADO FEDERAL,PP,8,2,10,0.2,0.8
3145,2018,PR,DEPUTADO FEDERAL,PSDB,8,4,12,0.3333333333333333,0.6666666666666666
3146,2018,PR,DEPUTADO FEDERAL,PSL,23,9,32,0.28125,0.71875
3147,2018,PR,DEPUTADO FEDERAL,NOVO,11,5,16,0.3125,0.6875
3148,2018,PR,DEPUTADO FEDERAL,PSD,15,6,21,0.2857142857142857,0.7142857142857143
3149,2018,PR,DEPUTADO FEDERAL,PRB,14,8,22,0.36363636363636365,0.6363636363636364
3150,2018,PR,DEPUTADO FEDERAL,PDT,10,4,14,0.2857142857142857,0.7142857142857143
3151,2018,PR,DEPUTADO FEDERAL,MDB,17,7,24,0.2916666666666667,0.7083333333333334
3152,2018,PR,DEPUTADO FEDERAL,PRTB,26,12,38,0.3157894736842105,0.6842105263157895
3153,2018,PR,DEPUTADO FEDERAL,PT,25,12,37,0.32432432432432434,0.6756756756756757
3154,2018,PR,DEPUTADO FEDERAL,PHS,10,1,11,0.09090909090909091,0.9090909090909091
3155,2018,PR,DEPUTADO FEDERAL,PODE,8,2,10,0.2,0.8
3156,2018,PR,DEPUTADO FEDERAL,PPL,19,6,25,0.24,0.76
3157,2018,PR,DEPUTADO FEDERAL,PC do B,13,7,20,0.35,0.65
3158,2018,PR,DEPUTADO FEDERAL,PR,2,1,3,0.3333333333333333,0.6666666666666666
3159,2018,PR,DEPUTADO FEDERAL,REDE,7,4,11,0.36363636363636365,0.6363636363636364
3160,2018,PR,DEPUTADO FEDERAL,AVANTE,3,3,6,0.5,0.5
3161,2018,PR,DEPUTADO FEDERAL,PTC,6,1,7,0.14285714285714285,0.8571428571428571
3162,2018,PR,DEPUTADO FEDERAL,PMB,0,2,2,1.0,0.0
3163,2018,PR,DEPUTADO FEDERAL,DEM,4,0,4,0.0,1.0
3164,2018,PR,DEPUTADO FEDERAL,PCO,1,1,2,0.5,0.5
3165,2018,PR,DEPUTADO FEDERAL,DC,4,3,7,0.42857142857142855,0.5714285714285714
3166,2018,PR,DEPUTADO FEDERAL,PRP,4,1,5,0.2,0.8
3167,2018,PR,DEPUTADO FEDERAL,PSC,3,4,7,0.5714285714285714,0.42857142857142855
3168,2018,PR,DEPUTADO FEDERAL,PPS,3,1,4,0.25,0.75
3169,2018,PR,DEPUTADO FEDERAL,PROS,2,2,4,0.5,0.5
3170,2018,PR,DEPUTADO FEDERAL,PATRI,4,3,7,0.42857142857142855,0.5714285714285714
3171,2018,PR,DEPUTADO FEDERAL,PMN,3,0,3,0.0,1.0
3172,2018,PR,DEPUTADO FEDERAL,SOLIDARIEDADE,1,0,1,0.0,1.0
3173,2018,PR,DEPUTADO FEDERAL,PTB,0,1,1,1.0,0.0
3174,2018,PR,SENADOR,PATRI,0,2,2,1.0,0.0
3175,2018,PR,SENADOR,PSOL,1,1,2,0.5,0.5
3176,2018,PR,SENADOR,PODE,1,0,1,0.0,1.0
3177,2018,PR,SENADOR,PDT,1,0,1,0.0,1.0
3178,2018,PR,SENADOR,PTB,1,0,1,0.0,1.0
3179,2018,PR,SENADOR,PRTB,2,0,2,0.0,1.0
3180,2018,PR,SENADOR,PSL,1,0,1,0.0,1.0
3181,2018,PR,SENADOR,MDB,1,0,1,0.0,1.0
3182,2018,PR,SENADOR,PCO,1,0,1,0.0,1.0
3183,2018,PR,SENADOR,PSDB,1,0,1,0.0,1.0
3184,2018,PR,SENADOR,PT,0,1,1,1.0,0.0
3185,2018,PR,SENADOR,REDE,1,0,1,0.0,1.0
3186,2018,PR,SENADOR,DC,1,0,1,0.0,1.0
3187,2010,PE,DEPUTADO ESTADUAL,PRTB,21,3,24,0.125,0.875
3188,2010,PE,DEPUTADO ESTADUAL,PV,19,7,26,0.2692307692307692,0.7307692307692307
3189,2010,PE,DEPUTADO ESTADUAL,PSOL,12,1,13,0.07692307692307693,0.9230769230769231
3190,2010,PE,DEPUTADO ESTADUAL,PHS,35,11,46,0.2391304347826087,0.7608695652173914
3191,2010,PE,DEPUTADO ESTADUAL,PTN,19,0,19,0.0,1.0
3192,2010,PE,DEPUTADO ESTADUAL,DEM,35,4,39,0.10256410256410256,0.8974358974358975
3193,2010,PE,DEPUTADO ESTADUAL,PR,8,0,8,0.0,1.0
3194,2010,PE,DEPUTADO ESTADUAL,PT do B,5,3,8,0.375,0.625
3195,2010,PE,DEPUTADO ESTADUAL,PPS,14,2,16,0.125,0.875
3196,2010,PE,DEPUTADO ESTADUAL,PRP,40,4,44,0.09090909090909091,0.9090909090909091
3197,2010,PE,DEPUTADO ESTADUAL,PSDB,19,1,20,0.05,0.95
3198,2010,PE,DEPUTADO ESTADUAL,PMN,20,3,23,0.13043478260869565,0.8695652173913043
3199,2010,PE,DEPUTADO ESTADUAL,PSDC,16,6,22,0.2727272727272727,0.7272727272727273
3200,2010,PE,DEPUTADO ESTADUAL,PTC,33,10,43,0.23255813953488372,0.7674418604651163
3201,2010,PE,DEPUTADO ESTADUAL,PSL,15,4,19,0.21052631578947367,0.7894736842105263
3202,2010,PE,DEPUTADO ESTADUAL,PT,12,2,14,0.14285714285714285,0.8571428571428571
3203,2010,PE,DEPUTADO ESTADUAL,PSB,17,4,21,0.19047619047619047,0.8095238095238095
3204,2010,PE,DEPUTADO ESTADUAL,PMDB,14,4,18,0.2222222222222222,0.7777777777777778
3205,2010,PE,DEPUTADO ESTADUAL,PCB,2,0,2,0.0,1.0
3206,2010,PE,DEPUTADO ESTADUAL,PTB,13,1,14,0.07142857142857142,0.9285714285714286
3207,2010,PE,DEPUTADO ESTADUAL,PC do B,6,0,6,0.0,1.0
3208,2010,PE,DEPUTADO ESTADUAL,PP,5,1,6,0.16666666666666666,0.8333333333333334
3209,2010,PE,DEPUTADO ESTADUAL,PSTU,2,1,3,0.3333333333333333,0.6666666666666666
3210,2010,PE,DEPUTADO ESTADUAL,PSC,1,1,2,0.5,0.5
3211,2010,PE,DEPUTADO ESTADUAL,PDT,7,0,7,0.0,1.0
3212,2010,PE,DEPUTADO ESTADUAL,PRB,1,0,1,0.0,1.0
3213,2010,PE,DEPUTADO FEDERAL,PRTB,11,1,12,0.08333333333333333,0.9166666666666666
3214,2010,PE,DEPUTADO FEDERAL,PTN,8,0,8,0.0,1.0
3215,2010,PE,DEPUTADO FEDERAL,PTC,26,2,28,0.07142857142857142,0.9285714285714286
3216,2010,PE,DEPUTADO FEDERAL,PSOL,11,0,11,0.0,1.0
3217,2010,PE,DEPUTADO FEDERAL,PSL,10,2,12,0.16666666666666666,0.8333333333333334
3218,2010,PE,DEPUTADO FEDERAL,PSDC,6,0,6,0.0,1.0
3219,2010,PE,DEPUTADO FEDERAL,PSB,6,1,7,0.14285714285714285,0.8571428571428571
3220,2010,PE,DEPUTADO FEDERAL,PR,3,0,3,0.0,1.0
3221,2010,PE,DEPUTADO FEDERAL,DEM,7,1,8,0.125,0.875
3222,2010,PE,DEPUTADO FEDERAL,PV,21,3,24,0.125,0.875
3223,2010,PE,DEPUTADO FEDERAL,PTB,9,0,9,0.0,1.0
3224,2010,PE,DEPUTADO FEDERAL,PMN,8,1,9,0.1111111111111111,0.8888888888888888
3225,2010,PE,DEPUTADO FEDERAL,PPS,5,0,5,0.0,1.0
3226,2010,PE,DEPUTADO FEDERAL,PRP,7,1,8,0.125,0.875
3227,2010,PE,DEPUTADO FEDERAL,PMDB,10,0,10,0.0,1.0
3228,2010,PE,DEPUTADO FEDERAL,PSDB,4,0,4,0.0,1.0
3229,2010,PE,DEPUTADO FEDERAL,PSC,1,0,1,0.0,1.0
3230,2010,PE,DEPUTADO FEDERAL,PHS,11,0,11,0.0,1.0
3231,2010,PE,DEPUTADO FEDERAL,PP,2,0,2,0.0,1.0
3232,2010,PE,DEPUTADO FEDERAL,PT,7,1,8,0.125,0.875
3233,2010,PE,DEPUTADO FEDERAL,PDT,5,1,6,0.16666666666666666,0.8333333333333334
3234,2010,PE,DEPUTADO FEDERAL,PT do B,1,0,1,0.0,1.0
3235,2010,PE,DEPUTADO FEDERAL,PC do B,1,1,2,0.5,0.5
3236,2010,PE,DEPUTADO FEDERAL,PCB,1,0,1,0.0,1.0
3237,2010,PE,DEPUTADO FEDERAL,PRB,2,0,2,0.0,1.0
3238,2010,PE,DEPUTADO FEDERAL,PSTU,0,1,1,1.0,0.0
3239,2010,PE,SENADOR,PTB,1,0,1,0.0,1.0
3240,2010,PE,SENADOR,PCB,2,0,2,0.0,1.0
3241,2010,PE,SENADOR,PSTU,1,1,2,0.5,0.5
3242,2010,PE,SENADOR,PT,1,0,1,0.0,1.0
3243,2010,PE,SENADOR,PSOL,1,0,1,0.0,1.0
3244,2010,PE,SENADOR,PV,0,1,1,1.0,0.0
3245,2010,PE,SENADOR,PRTB,1,0,1,0.0,1.0
3246,2010,PE,SENADOR,DEM,1,0,1,0.0,1.0
3247,2010,PE,SENADOR,PPS,1,0,1,0.0,1.0
3248,2014,PE,DEPUTADO ESTADUAL,PRTB,12,5,17,0.29411764705882354,0.7058823529411765
3249,2014,PE,DEPUTADO ESTADUAL,PV,19,8,27,0.2962962962962963,0.7037037037037037
3250,2014,PE,DEPUTADO ESTADUAL,PPS,14,6,20,0.3,0.7
3251,2014,PE,DEPUTADO ESTADUAL,PSL,16,15,31,0.4838709677419355,0.5161290322580645
3252,2014,PE,DEPUTADO ESTADUAL,SD,18,8,26,0.3076923076923077,0.6923076923076923
3253,2014,PE,DEPUTADO ESTADUAL,PSDC,17,1,18,0.05555555555555555,0.9444444444444444
3254,2014,PE,DEPUTADO ESTADUAL,PSB,30,12,42,0.2857142857142857,0.7142857142857143
3255,2014,PE,DEPUTADO ESTADUAL,PCB,2,1,3,0.3333333333333333,0.6666666666666666
3256,2014,PE,DEPUTADO ESTADUAL,PP,23,12,35,0.34285714285714286,0.6571428571428571
3257,2014,PE,DEPUTADO ESTADUAL,PR,5,3,8,0.375,0.625
3258,2014,PE,DEPUTADO ESTADUAL,PMN,17,9,26,0.34615384615384615,0.6538461538461539
3259,2014,PE,DEPUTADO ESTADUAL,PSDB,9,5,14,0.35714285714285715,0.6428571428571429
3260,2014,PE,DEPUTADO ESTADUAL,PHS,36,10,46,0.21739130434782608,0.782608695652174
3261,2014,PE,DEPUTADO ESTADUAL,PC do B,4,0,4,0.0,1.0
3262,2014,PE,DEPUTADO ESTADUAL,PRP,24,16,40,0.4,0.6
3263,2014,PE,DEPUTADO ESTADUAL,PDT,8,0,8,0.0,1.0
3264,2014,PE,DEPUTADO ESTADUAL,PSOL,29,12,41,0.2926829268292683,0.7073170731707317
3265,2014,PE,DEPUTADO ESTADUAL,PT,14,4,18,0.2222222222222222,0.7777777777777778
3266,2014,PE,DEPUTADO ESTADUAL,PROS,6,3,9,0.3333333333333333,0.6666666666666666
3267,2014,PE,DEPUTADO ESTADUAL,PTB,29,16,45,0.35555555555555557,0.6444444444444445
3268,2014,PE,DEPUTADO ESTADUAL,PT do B,6,0,6,0.0,1.0
3269,2014,PE,DEPUTADO ESTADUAL,PTN,15,8,23,0.34782608695652173,0.6521739130434783
3270,2014,PE,DEPUTADO ESTADUAL,PMDB,5,2,7,0.2857142857142857,0.7142857142857143
3271,2014,PE,DEPUTADO ESTADUAL,PSD,4,2,6,0.3333333333333333,0.6666666666666666
3272,2014,PE,DEPUTADO ESTADUAL,PSC,8,1,9,0.1111111111111111,0.8888888888888888
3273,2014,PE,DEPUTADO ESTADUAL,PPL,1,2,3,0.6666666666666666,0.3333333333333333
3274,2014,PE,DEPUTADO ESTADUAL,PRB,2,8,10,0.8,0.2
3275,2014,PE,DEPUTADO ESTADUAL,PTC,1,1,2,0.5,0.5
3276,2014,PE,DEPUTADO ESTADUAL,DEM,2,2,4,0.5,0.5
3277,2014,PE,DEPUTADO ESTADUAL,PSTU,1,2,3,0.6666666666666666,0.3333333333333333
3278,2014,PE,DEPUTADO FEDERAL,PV,1,1,2,0.5,0.5
3279,2014,PE,DEPUTADO FEDERAL,PSDB,4,0,4,0.0,1.0
3280,2014,PE,DEPUTADO FEDERAL,PSL,7,6,13,0.46153846153846156,0.5384615384615384
3281,2014,PE,DEPUTADO FEDERAL,PR,4,2,6,0.3333333333333333,0.6666666666666666
3282,2014,PE,DEPUTADO FEDERAL,PHS,8,2,10,0.2,0.8
3283,2014,PE,DEPUTADO FEDERAL,PMDB,3,1,4,0.25,0.75
3284,2014,PE,DEPUTADO FEDERAL,PTN,3,0,3,0.0,1.0
3285,2014,PE,DEPUTADO FEDERAL,PCB,3,2,5,0.4,0.6
3286,2014,PE,DEPUTADO FEDERAL,PP,5,0,5,0.0,1.0
3287,2014,PE,DEPUTADO FEDERAL,PSB,10,4,14,0.2857142857142857,0.7142857142857143
3288,2014,PE,DEPUTADO FEDERAL,PDT,2,1,3,0.3333333333333333,0.6666666666666666
3289,2014,PE,DEPUTADO FEDERAL,PRP,6,4,10,0.4,0.6
3290,2014,PE,DEPUTADO FEDERAL,PRTB,8,2,10,0.2,0.8
3291,2014,PE,DEPUTADO FEDERAL,PMN,7,3,10,0.3,0.7
3292,2014,PE,DEPUTADO FEDERAL,PSOL,6,4,10,0.4,0.6
3293,2014,PE,DEPUTADO FEDERAL,PRB,2,6,8,0.75,0.25
3294,2014,PE,DEPUTADO FEDERAL,PTB,16,8,24,0.3333333333333333,0.6666666666666666
3295,2014,PE,DEPUTADO FEDERAL,PPL,2,4,6,0.6666666666666666,0.3333333333333333
3296,2014,PE,DEPUTADO FEDERAL,PSTU,1,1,2,0.5,0.5
3297,2014,PE,DEPUTADO FEDERAL,PSC,1,0,1,0.0,1.0
3298,2014,PE,DEPUTADO FEDERAL,PTC,1,2,3,0.6666666666666666,0.3333333333333333
3299,2014,PE,DEPUTADO FEDERAL,PT,8,0,8,0.0,1.0
3300,2014,PE,DEPUTADO FEDERAL,PC do B,1,1,2,0.5,0.5
3301,2014,PE,DEPUTADO FEDERAL,PT do B,2,0,2,0.0,1.0
3302,2014,PE,DEPUTADO FEDERAL,PROS,1,0,1,0.0,1.0
3303,2014,PE,DEPUTADO FEDERAL,PSDC,3,2,5,0.4,0.6
3304,2014,PE,DEPUTADO FEDERAL,DEM,1,0,1,0.0,1.0
3305,2014,PE,DEPUTADO FEDERAL,SD,1,0,1,0.0,1.0
3306,2014,PE,DEPUTADO FEDERAL,PPS,1,0,1,0.0,1.0
3307,2014,PE,DEPUTADO FEDERAL,PSD,1,0,1,0.0,1.0
3308,2014,PE,SENADOR,PSTU,0,1,1,1.0,0.0
3309,2014,PE,SENADOR,PSOL,0,1,1,1.0,0.0
3310,2014,PE,SENADOR,PCB,1,0,1,0.0,1.0
3311,2014,PE,SENADOR,PSB,1,0,1,0.0,1.0
3312,2014,PE,SENADOR,PT,1,0,1,0.0,1.0
3313,2018,PE,DEPUTADO ESTADUAL,SOLIDARIEDADE,10,6,16,0.375,0.625
3314,2018,PE,DEPUTADO ESTADUAL,PRTB,18,8,26,0.3076923076923077,0.6923076923076923
3315,2018,PE,DEPUTADO ESTADUAL,PRP,35,21,56,0.375,0.625
3316,2018,PE,DEPUTADO ESTADUAL,PROS,23,5,28,0.17857142857142858,0.8214285714285714
3317,2018,PE,DEPUTADO ESTADUAL,PRB,14,3,17,0.17647058823529413,0.8235294117647058
3318,2018,PE,DEPUTADO ESTADUAL,PSDB,13,7,20,0.35,0.65
3319,2018,PE,DEPUTADO ESTADUAL,PPS,30,14,44,0.3181818181818182,0.6818181818181818
3320,2018,PE,DEPUTADO ESTADUAL,PATRI,30,13,43,0.3023255813953488,0.6976744186046512
3321,2018,PE,DEPUTADO ESTADUAL,PHS,14,5,19,0.2631578947368421,0.7368421052631579
3322,2018,PE,DEPUTADO ESTADUAL,PT,19,9,28,0.32142857142857145,0.6785714285714286
3323,2018,PE,DEPUTADO ESTADUAL,PC do B,42,18,60,0.3,0.7
3324,2018,PE,DEPUTADO ESTADUAL,PSOL,20,11,31,0.3548387096774194,0.6451612903225806
3325,2018,PE,DEPUTADO ESTADUAL,PSB,17,10,27,0.37037037037037035,0.6296296296296297
3326,2018,PE,DEPUTADO ESTADUAL,PP,36,11,47,0.23404255319148937,0.7659574468085106
3327,2018,PE,DEPUTADO ESTADUAL,AVANTE,20,13,33,0.3939393939393939,0.6060606060606061
3328,2018,PE,DEPUTADO ESTADUAL,PPL,9,0,9,0.0,1.0
3329,2018,PE,DEPUTADO ESTADUAL,MDB,1,0,1,0.0,1.0
3330,2018,PE,DEPUTADO ESTADUAL,PSC,28,12,40,0.3,0.7
3331,2018,PE,DEPUTADO ESTADUAL,PTB,10,4,14,0.2857142857142857,0.7142857142857143
3332,2018,PE,DEPUTADO ESTADUAL,REDE,9,4,13,0.3076923076923077,0.6923076923076923
3333,2018,PE,DEPUTADO ESTADUAL,PSL,13,5,18,0.2777777777777778,0.7222222222222222
3334,2018,PE,DEPUTADO ESTADUAL,DC,16,6,22,0.2727272727272727,0.7272727272727273
3335,2018,PE,DEPUTADO ESTADUAL,PR,6,3,9,0.3333333333333333,0.6666666666666666
3336,2018,PE,DEPUTADO ESTADUAL,PSD,3,1,4,0.25,0.75
3337,2018,PE,DEPUTADO ESTADUAL,PODE,2,2,4,0.5,0.5
3338,2018,PE,DEPUTADO ESTADUAL,DEM,6,4,10,0.4,0.6
3339,2018,PE,DEPUTADO ESTADUAL,PV,9,4,13,0.3076923076923077,0.6923076923076923
3340,2018,PE,DEPUTADO ESTADUAL,PMN,4,3,7,0.42857142857142855,0.5714285714285714
3341,2018,PE,DEPUTADO ESTADUAL,PDT,7,4,11,0.36363636363636365,0.6363636363636364
3342,2018,PE,DEPUTADO ESTADUAL,PSTU,1,2,3,0.6666666666666666,0.3333333333333333
3343,2018,PE,DEPUTADO ESTADUAL,PCB,2,1,3,0.3333333333333333,0.6666666666666666
3344,2018,PE,DEPUTADO ESTADUAL,PMB,0,1,1,1.0,0.0
3345,2018,PE,DEPUTADO ESTADUAL,PCO,1,0,1,0.0,1.0
3346,2018,PE,DEPUTADO ESTADUAL,PTC,1,0,1,0.0,1.0
3347,2018,PE,DEPUTADO FEDERAL,PATRI,26,12,38,0.3157894736842105,0.6842105263157895
3348,2018,PE,DEPUTADO FEDERAL,DEM,4,0,4,0.0,1.0
3349,2018,PE,DEPUTADO FEDERAL,PSOL,23,11,34,0.3235294117647059,0.6764705882352942
3350,2018,PE,DEPUTADO FEDERAL,PSB,10,6,16,0.375,0.625
3351,2018,PE,DEPUTADO FEDERAL,PPL,12,7,19,0.3684210526315789,0.631578947368421
3352,2018,PE,DEPUTADO FEDERAL,PRP,10,5,15,0.3333333333333333,0.6666666666666666
3353,2018,PE,DEPUTADO FEDERAL,PR,6,5,11,0.45454545454545453,0.5454545454545454
3354,2018,PE,DEPUTADO FEDERAL,REDE,18,8,26,0.3076923076923077,0.6923076923076923
3355,2018,PE,DEPUTADO FEDERAL,PTC,5,1,6,0.16666666666666666,0.8333333333333334
3356,2018,PE,DEPUTADO FEDERAL,PHS,8,3,11,0.2727272727272727,0.7272727272727273
3357,2018,PE,DEPUTADO FEDERAL,DC,11,5,16,0.3125,0.6875
3358,2018,PE,DEPUTADO FEDERAL,PTB,3,5,8,0.625,0.375
3359,2018,PE,DEPUTADO FEDERAL,PCB,3,1,4,0.25,0.75
3360,2018,PE,DEPUTADO FEDERAL,PV,5,3,8,0.375,0.625
3361,2018,PE,DEPUTADO FEDERAL,PT,11,5,16,0.3125,0.6875
3362,2018,PE,DEPUTADO FEDERAL,SOLIDARIEDADE,6,2,8,0.25,0.75
3363,2018,PE,DEPUTADO FEDERAL,PRTB,5,3,8,0.375,0.625
3364,2018,PE,DEPUTADO FEDERAL,PP,8,1,9,0.1111111111111111,0.8888888888888888
3365,2018,PE,DEPUTADO FEDERAL,PMN,7,4,11,0.36363636363636365,0.6363636363636364
3366,2018,PE,DEPUTADO FEDERAL,PSDB,3,1,4,0.25,0.75
3367,2018,PE,DEPUTADO FEDERAL,PPS,3,2,5,0.4,0.6
3368,2018,PE,DEPUTADO FEDERAL,PSC,4,2,6,0.3333333333333333,0.6666666666666666
3369,2018,PE,DEPUTADO FEDERAL,PSD,1,0,1,0.0,1.0
3370,2018,PE,DEPUTADO FEDERAL,PSL,9,3,12,0.25,0.75
3371,2018,PE,DEPUTADO FEDERAL,NOVO,6,4,10,0.4,0.6
3372,2018,PE,DEPUTADO FEDERAL,PROS,17,5,22,0.22727272727272727,0.7727272727272727
3373,2018,PE,DEPUTADO FEDERAL,PDT,7,2,9,0.2222222222222222,0.7777777777777778
3374,2018,PE,DEPUTADO FEDERAL,AVANTE,2,5,7,0.7142857142857143,0.2857142857142857
3375,2018,PE,DEPUTADO FEDERAL,MDB,2,0,2,0.0,1.0
3376,2018,PE,DEPUTADO FEDERAL,PRB,3,0,3,0.0,1.0
3377,2018,PE,DEPUTADO FEDERAL,PSTU,1,1,2,0.5,0.5
3378,2018,PE,DEPUTADO FEDERAL,PCO,1,0,1,0.0,1.0
3379,2018,PE,DEPUTADO FEDERAL,PODE,2,1,3,0.3333333333333333,0.6666666666666666
3380,2018,PE,DEPUTADO FEDERAL,PC do B,1,0,1,0.0,1.0
3381,2018,PE,SENADOR,PSOL,0,2,2,1.0,0.0
3382,2018,PE,SENADOR,AVANTE,1,0,1,0.0,1.0
3383,2018,PE,SENADOR,PSDB,1,0,1,0.0,1.0
3384,2018,PE,SENADOR,PROS,0,1,1,1.0,0.0
3385,2018,PE,SENADOR,PT,1,0,1,0.0,1.0
3386,2018,PE,SENADOR,DEM,1,0,1,0.0,1.0
3387,2018,PE,SENADOR,MDB,1,0,1,0.0,1.0
3388,2018,PE,SENADOR,PCO,1,0,1,0.0,1.0
3389,2018,PE,SENADOR,PSTU,1,0,1,0.0,1.0
3390,2018,PE,SENADOR,REDE,1,1,2,0.5,0.5
3391,2010,PI,DEPUTADO ESTADUAL,PMN,2,0,2,0.0,1.0
3392,2010,PI,DEPUTADO ESTADUAL,PV,19,4,23,0.17391304347826086,0.8260869565217391
3393,2010,PI,DEPUTADO ESTADUAL,PSOL,3,1,4,0.25,0.75
3394,2010,PI,DEPUTADO ESTADUAL,PMDB,9,4,13,0.3076923076923077,0.6923076923076923
3395,2010,PI,DEPUTADO ESTADUAL,PSDB,16,5,21,0.23809523809523808,0.7619047619047619
3396,2010,PI,DEPUTADO ESTADUAL,PSB,8,4,12,0.3333333333333333,0.6666666666666666
3397,2010,PI,DEPUTADO ESTADUAL,PSL,0,1,1,1.0,0.0
3398,2010,PI,DEPUTADO ESTADUAL,DEM,14,4,18,0.2222222222222222,0.7777777777777778
3399,2010,PI,DEPUTADO ESTADUAL,PRP,3,0,3,0.0,1.0
3400,2010,PI,DEPUTADO ESTADUAL,PTN,4,1,5,0.2,0.8
3401,2010,PI,DEPUTADO ESTADUAL,PTC,11,8,19,0.42105263157894735,0.5789473684210527
3402,2010,PI,DEPUTADO ESTADUAL,PPS,1,1,2,0.5,0.5
3403,2010,PI,DEPUTADO ESTADUAL,PDT,10,1,11,0.09090909090909091,0.9090909090909091
3404,2010,PI,DEPUTADO ESTADUAL,PTB,17,4,21,0.19047619047619047,0.8095238095238095
3405,2010,PI,DEPUTADO ESTADUAL,PT do B,14,3,17,0.17647058823529413,0.8235294117647058
3406,2010,PI,DEPUTADO ESTADUAL,PHS,3,1,4,0.25,0.75
3407,2010,PI,DEPUTADO ESTADUAL,PT,16,6,22,0.2727272727272727,0.7272727272727273
3408,2010,PI,DEPUTADO ESTADUAL,PRB,3,3,6,0.5,0.5
3409,2010,PI,DEPUTADO ESTADUAL,PRTB,5,0,5,0.0,1.0
3410,2010,PI,DEPUTADO ESTADUAL,PP,3,1,4,0.25,0.75
3411,2010,PI,DEPUTADO ESTADUAL,PSC,3,2,5,0.4,0.6
3412,2010,PI,DEPUTADO ESTADUAL,PC do B,1,2,3,0.6666666666666666,0.3333333333333333
3413,2010,PI,DEPUTADO ESTADUAL,PR,1,1,2,0.5,0.5
3414,2010,PI,DEPUTADO ESTADUAL,PCO,1,0,1,0.0,1.0
3415,2010,PI,DEPUTADO ESTADUAL,PSTU,0,1,1,1.0,0.0
3416,2010,PI,DEPUTADO FEDERAL,PSDB,6,5,11,0.45454545454545453,0.5454545454545454
3417,2010,PI,DEPUTADO FEDERAL,PHS,2,0,2,0.0,1.0
3418,2010,PI,DEPUTADO FEDERAL,PT do B,2,1,3,0.3333333333333333,0.6666666666666666
3419,2010,PI,DEPUTADO FEDERAL,PRTB,2,0,2,0.0,1.0
3420,2010,PI,DEPUTADO FEDERAL,PTN,1,0,1,0.0,1.0
3421,2010,PI,DEPUTADO FEDERAL,PT,7,1,8,0.125,0.875
3422,2010,PI,DEPUTADO FEDERAL,PSOL,3,2,5,0.4,0.6
3423,2010,PI,DEPUTADO FEDERAL,PSDC,5,4,9,0.4444444444444444,0.5555555555555556
3424,2010,PI,DEPUTADO FEDERAL,PSB,3,4,7,0.5714285714285714,0.42857142857142855
3425,2010,PI,DEPUTADO FEDERAL,PP,5,1,6,0.16666666666666666,0.8333333333333334
3426,2010,PI,DEPUTADO FEDERAL,PSL,6,2,8,0.25,0.75
3427,2010,PI,DEPUTADO FEDERAL,PV,4,0,4,0.0,1.0
3428,2010,PI,DEPUTADO FEDERAL,PRB,2,2,4,0.5,0.5
3429,2010,PI,DEPUTADO FEDERAL,PSTU,1,0,1,0.0,1.0
3430,2010,PI,DEPUTADO FEDERAL,PTB,5,6,11,0.5454545454545454,0.45454545454545453
3431,2010,PI,DEPUTADO FEDERAL,PTC,3,0,3,0.0,1.0
3432,2010,PI,DEPUTADO FEDERAL,PSC,4,0,4,0.0,1.0
3433,2010,PI,DEPUTADO FEDERAL,PMDB,7,2,9,0.2222222222222222,0.7777777777777778
3434,2010,PI,DEPUTADO FEDERAL,PDT,3,0,3,0.0,1.0
3435,2010,PI,DEPUTADO FEDERAL,DEM,5,0,5,0.0,1.0
3436,2010,PI,DEPUTADO FEDERAL,PR,1,0,1,0.0,1.0
3437,2010,PI,DEPUTADO FEDERAL,PPS,3,1,4,0.25,0.75
3438,2010,PI,DEPUTADO FEDERAL,PMN,1,1,2,0.5,0.5
3439,2010,PI,DEPUTADO FEDERAL,PC do B,1,1,2,0.5,0.5
3440,2010,PI,DEPUTADO FEDERAL,PCO,0,1,1,1.0,0.0
3441,2010,PI,DEPUTADO FEDERAL,PRP,1,0,1,0.0,1.0
3442,2010,PI,SENADOR,PCO,0,1,1,1.0,0.0
3443,2010,PI,SENADOR,PSL,1,0,1,0.0,1.0
3444,2010,PI,SENADOR,PT,2,0,2,0.0,1.0
3445,2010,PI,SENADOR,PV,1,0,1,0.0,1.0
3446,2010,PI,SENADOR,PP,2,0,2,0.0,1.0
3447,2010,PI,SENADOR,PSC,1,0,1,0.0,1.0
3448,2010,PI,SENADOR,DEM,1,0,1,0.0,1.0
3449,2010,PI,SENADOR,PSTU,1,0,1,0.0,1.0
3450,2010,PI,SENADOR,PSOL,1,1,2,0.5,0.5
3451,2010,PI,SENADOR,PMN,1,0,1,0.0,1.0
3452,2014,PI,DEPUTADO ESTADUAL,PT do B,10,3,13,0.23076923076923078,0.7692307692307693
3453,2014,PI,DEPUTADO ESTADUAL,PV,11,9,20,0.45,0.55
3454,2014,PI,DEPUTADO ESTADUAL,PRP,12,7,19,0.3684210526315789,0.631578947368421
3455,2014,PI,DEPUTADO ESTADUAL,PT,13,6,19,0.3157894736842105,0.6842105263157895
3456,2014,PI,DEPUTADO ESTADUAL,PMDB,9,4,13,0.3076923076923077,0.6923076923076923
3457,2014,PI,DEPUTADO ESTADUAL,PRB,2,1,3,0.3333333333333333,0.6666666666666666
3458,2014,PI,DEPUTADO ESTADUAL,PSOL,4,2,6,0.3333333333333333,0.6666666666666666
3459,2014,PI,DEPUTADO ESTADUAL,PSDB,5,3,8,0.375,0.625
3460,2014,PI,DEPUTADO ESTADUAL,PMN,3,0,3,0.0,1.0
3461,2014,PI,DEPUTADO ESTADUAL,PR,1,2,3,0.6666666666666666,0.3333333333333333
3462,2014,PI,DEPUTADO ESTADUAL,PSC,9,4,13,0.3076923076923077,0.6923076923076923
3463,2014,PI,DEPUTADO ESTADUAL,PEN,7,2,9,0.2222222222222222,0.7777777777777778
3464,2014,PI,DEPUTADO ESTADUAL,PTC,11,11,22,0.5,0.5
3465,2014,PI,DEPUTADO ESTADUAL,PSB,13,6,19,0.3157894736842105,0.6842105263157895
3466,2014,PI,DEPUTADO ESTADUAL,PTB,7,5,12,0.4166666666666667,0.5833333333333334
3467,2014,PI,DEPUTADO ESTADUAL,PDT,7,1,8,0.125,0.875
3468,2014,PI,DEPUTADO ESTADUAL,PSD,8,4,12,0.3333333333333333,0.6666666666666666
3469,2014,PI,DEPUTADO ESTADUAL,PCB,2,1,3,0.3333333333333333,0.6666666666666666
3470,2014,PI,DEPUTADO ESTADUAL,PHS,4,2,6,0.3333333333333333,0.6666666666666666
3471,2014,PI,DEPUTADO ESTADUAL,SD,2,0,2,0.0,1.0
3472,2014,PI,DEPUTADO ESTADUAL,PC do B,2,0,2,0.0,1.0
3473,2014,PI,DEPUTADO ESTADUAL,PPL,1,1,2,0.5,0.5
3474,2014,PI,DEPUTADO ESTADUAL,PPS,7,1,8,0.125,0.875
3475,2014,PI,DEPUTADO ESTADUAL,PCO,1,1,2,0.5,0.5
3476,2014,PI,DEPUTADO ESTADUAL,PP,5,1,6,0.16666666666666666,0.8333333333333334
3477,2014,PI,DEPUTADO ESTADUAL,PSL,7,3,10,0.3,0.7
3478,2014,PI,DEPUTADO ESTADUAL,PSDC,3,2,5,0.4,0.6
3479,2014,PI,DEPUTADO ESTADUAL,PTN,1,0,1,0.0,1.0
3480,2014,PI,DEPUTADO ESTADUAL,PROS,2,0,2,0.0,1.0
3481,2014,PI,DEPUTADO ESTADUAL,DEM,3,1,4,0.25,0.75
3482,2014,PI,DEPUTADO ESTADUAL,PSTU,2,1,3,0.3333333333333333,0.6666666666666666
3483,2014,PI,DEPUTADO FEDERAL,PSDC,0,1,1,1.0,0.0
3484,2014,PI,DEPUTADO FEDERAL,PSOL,2,2,4,0.5,0.5
3485,2014,PI,DEPUTADO FEDERAL,PHS,7,3,10,0.3,0.7
3486,2014,PI,DEPUTADO FEDERAL,PCB,3,1,4,0.25,0.75
3487,2014,PI,DEPUTADO FEDERAL,PTB,5,3,8,0.375,0.625
3488,2014,PI,DEPUTADO FEDERAL,PPL,3,2,5,0.4,0.6
3489,2014,PI,DEPUTADO FEDERAL,PTC,2,1,3,0.3333333333333333,0.6666666666666666
3490,2014,PI,DEPUTADO FEDERAL,DEM,3,1,4,0.25,0.75
3491,2014,PI,DEPUTADO FEDERAL,PTN,1,0,1,0.0,1.0
3492,2014,PI,DEPUTADO FEDERAL,PMN,2,1,3,0.3333333333333333,0.6666666666666666
3493,2014,PI,DEPUTADO FEDERAL,PC do B,1,1,2,0.5,0.5
3494,2014,PI,DEPUTADO FEDERAL,PMDB,4,1,5,0.2,0.8
3495,2014,PI,DEPUTADO FEDERAL,PSTU,1,2,3,0.6666666666666666,0.3333333333333333
3496,2014,PI,DEPUTADO FEDERAL,PR,1,0,1,0.0,1.0
3497,2014,PI,DEPUTADO FEDERAL,PPS,1,1,2,0.5,0.5
3498,2014,PI,DEPUTADO FEDERAL,PV,7,4,11,0.36363636363636365,0.6363636363636364
3499,2014,PI,DEPUTADO FEDERAL,SD,1,0,1,0.0,1.0
3500,2014,PI,DEPUTADO FEDERAL,PEN,2,0,2,0.0,1.0
3501,2014,PI,DEPUTADO FEDERAL,PDT,3,0,3,0.0,1.0
3502,2014,PI,DEPUTADO FEDERAL,PRP,6,3,9,0.3333333333333333,0.6666666666666666
3503,2014,PI,DEPUTADO FEDERAL,PRB,2,1,3,0.3333333333333333,0.6666666666666666
3504,2014,PI,DEPUTADO FEDERAL,PSB,4,0,4,0.0,1.0
3505,2014,PI,DEPUTADO FEDERAL,PSD,2,1,3,0.3333333333333333,0.6666666666666666
3506,2014,PI,DEPUTADO FEDERAL,PT,4,2,6,0.3333333333333333,0.6666666666666666
3507,2014,PI,DEPUTADO FEDERAL,PT do B,1,2,3,0.6666666666666666,0.3333333333333333
3508,2014,PI,DEPUTADO FEDERAL,PP,1,1,2,0.5,0.5
3509,2014,PI,DEPUTADO FEDERAL,PSC,1,1,2,0.5,0.5
3510,2014,PI,DEPUTADO FEDERAL,PSL,2,2,4,0.5,0.5
3511,2014,PI,DEPUTADO FEDERAL,PROS,1,0,1,0.0,1.0
3512,2014,PI,DEPUTADO FEDERAL,PCO,1,0,1,0.0,1.0
3513,2014,PI,SENADOR,PPL,1,0,1,0.0,1.0
3514,2014,PI,SENADOR,PCB,1,0,1,0.0,1.0
3515,2014,PI,SENADOR,PSB,1,0,1,0.0,1.0
3516,2014,PI,SENADOR,PTB,1,0,1,0.0,1.0
3517,2014,PI,SENADOR,PSTU,1,0,1,0.0,1.0
3518,2014,PI,SENADOR,PSC,1,0,1,0.0,1.0
3519,2018,PI,DEPUTADO ESTADUAL,PROS,15,7,22,0.3181818181818182,0.6818181818181818
3520,2018,PI,DEPUTADO ESTADUAL,SOLIDARIEDADE,9,2,11,0.18181818181818182,0.8181818181818182
3521,2018,PI,DEPUTADO ESTADUAL,PTB,3,2,5,0.4,0.6
3522,2018,PI,DEPUTADO ESTADUAL,PTC,5,3,8,0.375,0.625
3523,2018,PI,DEPUTADO ESTADUAL,PSOL,5,1,6,0.16666666666666666,0.8333333333333334
3524,2018,PI,DEPUTADO ESTADUAL,PP,5,4,9,0.4444444444444444,0.5555555555555556
3525,2018,PI,DEPUTADO ESTADUAL,PHS,11,3,14,0.21428571428571427,0.7857142857142857
3526,2018,PI,DEPUTADO ESTADUAL,PRP,18,8,26,0.3076923076923077,0.6923076923076923
3527,2018,PI,DEPUTADO ESTADUAL,DC,9,5,14,0.35714285714285715,0.6428571428571429
3528,2018,PI,DEPUTADO ESTADUAL,PT,12,4,16,0.25,0.75
3529,2018,PI,DEPUTADO ESTADUAL,PRTB,4,0,4,0.0,1.0
3530,2018,PI,DEPUTADO ESTADUAL,REDE,2,2,4,0.5,0.5
3531,2018,PI,DEPUTADO ESTADUAL,PSDB,3,2,5,0.4,0.6
3532,2018,PI,DEPUTADO ESTADUAL,PPS,3,0,3,0.0,1.0
3533,2018,PI,DEPUTADO ESTADUAL,PV,2,3,5,0.6,0.4
3534,2018,PI,DEPUTADO ESTADUAL,PSD,1,1,2,0.5,0.5
3535,2018,PI,DEPUTADO ESTADUAL,PDT,1,0,1,0.0,1.0
3536,2018,PI,DEPUTADO ESTADUAL,MDB,8,4,12,0.3333333333333333,0.6666666666666666
3537,2018,PI,DEPUTADO ESTADUAL,PODE,5,0,5,0.0,1.0
3538,2018,PI,DEPUTADO ESTADUAL,PATRI,3,1,4,0.25,0.75
3539,2018,PI,DEPUTADO ESTADUAL,AVANTE,0,1,1,1.0,0.0
3540,2018,PI,DEPUTADO ESTADUAL,PC do B,1,2,3,0.6666666666666666,0.3333333333333333
3541,2018,PI,DEPUTADO ESTADUAL,PCB,0,1,1,1.0,0.0
3542,2018,PI,DEPUTADO ESTADUAL,PSB,5,2,7,0.2857142857142857,0.7142857142857143
3543,2018,PI,DEPUTADO ESTADUAL,PSL,5,2,7,0.2857142857142857,0.7142857142857143
3544,2018,PI,DEPUTADO ESTADUAL,PCO,0,1,1,1.0,0.0
3545,2018,PI,DEPUTADO ESTADUAL,PMN,2,4,6,0.6666666666666666,0.3333333333333333
3546,2018,PI,DEPUTADO ESTADUAL,PR,5,2,7,0.2857142857142857,0.7142857142857143
3547,2018,PI,DEPUTADO ESTADUAL,PSC,2,1,3,0.3333333333333333,0.6666666666666666
3548,2018,PI,DEPUTADO ESTADUAL,PPL,1,0,1,0.0,1.0
3549,2018,PI,DEPUTADO ESTADUAL,PRB,1,0,1,0.0,1.0
3550,2018,PI,DEPUTADO ESTADUAL,PSTU,1,0,1,0.0,1.0
3551,2018,PI,DEPUTADO FEDERAL,PSB,5,1,6,0.16666666666666666,0.8333333333333334
3552,2018,PI,DEPUTADO FEDERAL,PV,6,4,10,0.4,0.6
3553,2018,PI,DEPUTADO FEDERAL,PMN,4,1,5,0.2,0.8
3554,2018,PI,DEPUTADO FEDERAL,PSL,4,3,7,0.42857142857142855,0.5714285714285714
3555,2018,PI,DEPUTADO FEDERAL,PRB,3,2,5,0.4,0.6
3556,2018,PI,DEPUTADO FEDERAL,PPS,4,1,5,0.2,0.8
3557,2018,PI,DEPUTADO FEDERAL,PODE,1,1,2,0.5,0.5
3558,2018,PI,DEPUTADO FEDERAL,PT,3,4,7,0.5714285714285714,0.42857142857142855
3559,2018,PI,DEPUTADO FEDERAL,MDB,3,0,3,0.0,1.0
3560,2018,PI,DEPUTADO FEDERAL,PSOL,6,3,9,0.3333333333333333,0.6666666666666666
3561,2018,PI,DEPUTADO FEDERAL,PRTB,6,4,10,0.4,0.6
3562,2018,PI,DEPUTADO FEDERAL,PTB,1,1,2,0.5,0.5
3563,2018,PI,DEPUTADO FEDERAL,PRP,7,3,10,0.3,0.7
3564,2018,PI,DEPUTADO FEDERAL,DC,5,3,8,0.375,0.625
3565,2018,PI,DEPUTADO FEDERAL,PROS,4,2,6,0.3333333333333333,0.6666666666666666
3566,2018,PI,DEPUTADO FEDERAL,PSDB,4,3,7,0.42857142857142855,0.5714285714285714
3567,2018,PI,DEPUTADO FEDERAL,REDE,4,1,5,0.2,0.8
3568,2018,PI,DEPUTADO FEDERAL,PSC,4,3,7,0.42857142857142855,0.5714285714285714
3569,2018,PI,DEPUTADO FEDERAL,PR,1,0,1,0.0,1.0
3570,2018,PI,DEPUTADO FEDERAL,AVANTE,1,1,2,0.5,0.5
3571,2018,PI,DEPUTADO FEDERAL,PHS,3,1,4,0.25,0.75
3572,2018,PI,DEPUTADO FEDERAL,PATRI,2,0,2,0.0,1.0
3573,2018,PI,DEPUTADO FEDERAL,PP,3,2,5,0.4,0.6
3574,2018,PI,DEPUTADO FEDERAL,PC do B,0,1,1,1.0,0.0
3575,2018,PI,DEPUTADO FEDERAL,PDT,1,0,1,0.0,1.0
3576,2018,PI,DEPUTADO FEDERAL,PCO,1,0,1,0.0,1.0
3577,2018,PI,DEPUTADO FEDERAL,PPL,1,0,1,0.0,1.0
3578,2018,PI,DEPUTADO FEDERAL,PTC,1,1,2,0.5,0.5
3579,2018,PI,DEPUTADO FEDERAL,PSD,1,0,1,0.0,1.0
3580,2018,PI,DEPUTADO FEDERAL,SOLIDARIEDADE,2,1,3,0.3333333333333333,0.6666666666666666
3581,2018,PI,DEPUTADO FEDERAL,PCB,1,0,1,0.0,1.0
3582,2018,PI,DEPUTADO FEDERAL,DEM,1,0,1,0.0,1.0
3583,2018,PI,DEPUTADO FEDERAL,PSTU,1,0,1,0.0,1.0
3584,2018,PI,SENADOR,PRB,1,0,1,0.0,1.0
3585,2018,PI,SENADOR,PSB,1,0,1,0.0,1.0
3586,2018,PI,SENADOR,PP,1,0,1,0.0,1.0
3587,2018,PI,SENADOR,PCO,0,1,1,1.0,0.0
3588,2018,PI,SENADOR,PSOL,1,0,1,0.0,1.0
3589,2018,PI,SENADOR,PCB,1,0,1,0.0,1.0
3590,2018,PI,SENADOR,PTC,1,0,1,0.0,1.0
3591,2018,PI,SENADOR,AVANTE,1,0,1,0.0,1.0
3592,2018,PI,SENADOR,DC,2,0,2,0.0,1.0
3593,2018,PI,SENADOR,REDE,1,0,1,0.0,1.0
3594,2018,PI,SENADOR,PSC,1,0,1,0.0,1.0
3595,2018,PI,SENADOR,MDB,1,0,1,0.0,1.0
3596,2018,PI,SENADOR,PSL,2,0,2,0.0,1.0
3597,2018,PI,SENADOR,DEM,1,0,1,0.0,1.0
3598,2018,PI,SENADOR,PSTU,1,0,1,0.0,1.0
3599,2018,PI,SENADOR,PRP,0,1,1,1.0,0.0
3600,2010,RJ,DEPUTADO ESTADUAL,PR,73,33,106,0.3113207547169811,0.6886792452830188
3601,2010,RJ,DEPUTADO ESTADUAL,PTC,73,32,105,0.3047619047619048,0.6952380952380952
3602,2010,RJ,DEPUTADO ESTADUAL,PHS,51,25,76,0.32894736842105265,0.6710526315789473
3603,2010,RJ,DEPUTADO ESTADUAL,PRTB,44,11,55,0.2,0.8
3604,2010,RJ,DEPUTADO ESTADUAL,PDT,71,31,102,0.30392156862745096,0.696078431372549
3605,2010,RJ,DEPUTADO ESTADUAL,PSOL,43,18,61,0.29508196721311475,0.7049180327868853
3606,2010,RJ,DEPUTADO ESTADUAL,PSB,54,27,81,0.3333333333333333,0.6666666666666666
3607,2010,RJ,DEPUTADO ESTADUAL,PMDB,64,29,93,0.3118279569892473,0.6881720430107527
3608,2010,RJ,DEPUTADO ESTADUAL,PSDB,42,14,56,0.25,0.75
3609,2010,RJ,DEPUTADO ESTADUAL,PTB,50,19,69,0.2753623188405797,0.7246376811594203
3610,2010,RJ,DEPUTADO ESTADUAL,PV,61,26,87,0.2988505747126437,0.7011494252873564
3611,2010,RJ,DEPUTADO ESTADUAL,PC do B,63,26,89,0.29213483146067415,0.7078651685393258
3612,2010,RJ,DEPUTADO ESTADUAL,PRP,67,25,92,0.2717391304347826,0.7282608695652174
3613,2010,RJ,DEPUTADO ESTADUAL,PPS,19,10,29,0.3448275862068966,0.6551724137931034
3614,2010,RJ,DEPUTADO ESTADUAL,PTN,48,17,65,0.26153846153846155,0.7384615384615385
3615,2010,RJ,DEPUTADO ESTADUAL,PT,56,24,80,0.3,0.7
3616,2010,RJ,DEPUTADO ESTADUAL,PSDC,47,23,70,0.32857142857142857,0.6714285714285714
3617,2010,RJ,DEPUTADO ESTADUAL,PSL,44,24,68,0.35294117647058826,0.6470588235294118
3618,2010,RJ,DEPUTADO ESTADUAL,PP,64,30,94,0.3191489361702128,0.6808510638297872
3619,2010,RJ,DEPUTADO ESTADUAL,PT do B,73,34,107,0.3177570093457944,0.6822429906542056
3620,2010,RJ,DEPUTADO ESTADUAL,PSC,73,32,105,0.3047619047619048,0.6952380952380952
3621,2010,RJ,DEPUTADO ESTADUAL,PMN,15,7,22,0.3181818181818182,0.6818181818181818
3622,2010,RJ,DEPUTADO ESTADUAL,PRB,49,21,70,0.3,0.7
3623,2010,RJ,DEPUTADO ESTADUAL,DEM,39,19,58,0.3275862068965517,0.6724137931034483
3624,2010,RJ,DEPUTADO ESTADUAL,PCB,1,2,3,0.6666666666666666,0.3333333333333333
3625,2010,RJ,DEPUTADO ESTADUAL,PSTU,3,3,6,0.5,0.5
3626,2010,RJ,DEPUTADO FEDERAL,PTN,14,6,20,0.3,0.7
3627,2010,RJ,DEPUTADO FEDERAL,PRB,48,20,68,0.29411764705882354,0.7058823529411765
3628,2010,RJ,DEPUTADO FEDERAL,PSDB,23,15,38,0.39473684210526316,0.6052631578947368
3629,2010,RJ,DEPUTADO FEDERAL,PTB,16,5,21,0.23809523809523808,0.7619047619047619
3630,2010,RJ,DEPUTADO FEDERAL,DEM,30,5,35,0.14285714285714285,0.8571428571428571
3631,2010,RJ,DEPUTADO FEDERAL,PTC,13,6,19,0.3157894736842105,0.6842105263157895
3632,2010,RJ,DEPUTADO FEDERAL,PR,48,22,70,0.3142857142857143,0.6857142857142857
3633,2010,RJ,DEPUTADO FEDERAL,PP,20,7,27,0.25925925925925924,0.7407407407407407
3634,2010,RJ,DEPUTADO FEDERAL,PMDB,31,14,45,0.3111111111111111,0.6888888888888889
3635,2010,RJ,DEPUTADO FEDERAL,PV,44,18,62,0.2903225806451613,0.7096774193548387
3636,2010,RJ,DEPUTADO FEDERAL,PSB,39,19,58,0.3275862068965517,0.6724137931034483
3637,2010,RJ,DEPUTADO FEDERAL,PRTB,25,6,31,0.1935483870967742,0.8064516129032258
3638,2010,RJ,DEPUTADO FEDERAL,PSOL,28,12,40,0.3,0.7
3639,2010,RJ,DEPUTADO FEDERAL,PHS,14,10,24,0.4166666666666667,0.5833333333333334
3640,2010,RJ,DEPUTADO FEDERAL,PT,35,16,51,0.3137254901960784,0.6862745098039216
3641,2010,RJ,DEPUTADO FEDERAL,PT do B,48,18,66,0.2727272727272727,0.7272727272727273
3642,2010,RJ,DEPUTADO FEDERAL,PC do B,27,13,40,0.325,0.675
3643,2010,RJ,DEPUTADO FEDERAL,PRP,17,8,25,0.32,0.68
3644,2010,RJ,DEPUTADO FEDERAL,PSC,13,6,19,0.3157894736842105,0.6842105263157895
3645,2010,RJ,DEPUTADO FEDERAL,PDT,46,20,66,0.30303030303030304,0.696969696969697
3646,2010,RJ,DEPUTADO FEDERAL,PSTU,4,2,6,0.3333333333333333,0.6666666666666666
3647,2010,RJ,DEPUTADO FEDERAL,PSDC,8,5,13,0.38461538461538464,0.6153846153846154
3648,2010,RJ,DEPUTADO FEDERAL,PPS,13,8,21,0.38095238095238093,0.6190476190476191
3649,2010,RJ,DEPUTADO FEDERAL,PMN,18,9,27,0.3333333333333333,0.6666666666666666
3650,2010,RJ,DEPUTADO FEDERAL,PSL,22,14,36,0.3888888888888889,0.6111111111111112
3651,2010,RJ,DEPUTADO FEDERAL,PCB,1,0,1,0.0,1.0
3652,2010,RJ,SENADOR,PT do B,2,0,2,0.0,1.0
3653,2010,RJ,SENADOR,DEM,1,0,1,0.0,1.0
3654,2010,RJ,SENADOR,PSTU,2,0,2,0.0,1.0
3655,2010,RJ,SENADOR,PSOL,1,0,1,0.0,1.0
3656,2010,RJ,SENADOR,PMDB,1,0,1,0.0,1.0
3657,2010,RJ,SENADOR,PT,1,0,1,0.0,1.0
3658,2010,RJ,SENADOR,PPS,1,0,1,0.0,1.0
3659,2010,RJ,SENADOR,PRB,1,0,1,0.0,1.0
3660,2010,RJ,SENADOR,PCB,1,0,1,0.0,1.0
3661,2014,RJ,DEPUTADO ESTADUAL,PSL,72,32,104,0.3076923076923077,0.6923076923076923
3662,2014,RJ,DEPUTADO ESTADUAL,PSOL,50,21,71,0.29577464788732394,0.704225352112676
3663,2014,RJ,DEPUTADO ESTADUAL,PTC,57,35,92,0.3804347826086957,0.6195652173913043
3664,2014,RJ,DEPUTADO ESTADUAL,PPS,14,10,24,0.4166666666666667,0.5833333333333334
3665,2014,RJ,DEPUTADO ESTADUAL,SD,46,18,64,0.28125,0.71875
3666,2014,RJ,DEPUTADO ESTADUAL,PPL,27,10,37,0.2702702702702703,0.7297297297297297
3667,2014,RJ,DEPUTADO ESTADUAL,PP,45,20,65,0.3076923076923077,0.6923076923076923
3668,2014,RJ,DEPUTADO ESTADUAL,PSC,39,7,46,0.15217391304347827,0.8478260869565217
3669,2014,RJ,DEPUTADO ESTADUAL,PSTU,13,6,19,0.3157894736842105,0.6842105263157895
3670,2014,RJ,DEPUTADO ESTADUAL,PSDB,34,12,46,0.2608695652173913,0.7391304347826086
3671,2014,RJ,DEPUTADO ESTADUAL,PSDC,60,27,87,0.3103448275862069,0.6896551724137931
3672,2014,RJ,DEPUTADO ESTADUAL,PV,48,19,67,0.2835820895522388,0.7164179104477612
3673,2014,RJ,DEPUTADO ESTADUAL,PRTB,58,26,84,0.30952380952380953,0.6904761904761905
3674,2014,RJ,DEPUTADO ESTADUAL,DEM,53,22,75,0.29333333333333333,0.7066666666666667
3675,2014,RJ,DEPUTADO ESTADUAL,PT do B,67,28,95,0.29473684210526313,0.7052631578947368
3676,2014,RJ,DEPUTADO ESTADUAL,PT,50,21,71,0.29577464788732394,0.704225352112676
3677,2014,RJ,DEPUTADO ESTADUAL,PR,70,40,110,0.36363636363636365,0.6363636363636364
3678,2014,RJ,DEPUTADO ESTADUAL,PMN,9,4,13,0.3076923076923077,0.6923076923076923
3679,2014,RJ,DEPUTADO ESTADUAL,PHS,72,33,105,0.3142857142857143,0.6857142857142857
3680,2014,RJ,DEPUTADO ESTADUAL,PRB,67,29,96,0.3020833333333333,0.6979166666666666
3681,2014,RJ,DEPUTADO ESTADUAL,PC do B,58,25,83,0.30120481927710846,0.6987951807228916
3682,2014,RJ,DEPUTADO ESTADUAL,PMDB,45,20,65,0.3076923076923077,0.6923076923076923
3683,2014,RJ,DEPUTADO ESTADUAL,PTN,34,18,52,0.34615384615384615,0.6538461538461539
3684,2014,RJ,DEPUTADO ESTADUAL,PROS,23,4,27,0.14814814814814814,0.8518518518518519
3685,2014,RJ,DEPUTADO ESTADUAL,PSB,67,29,96,0.3020833333333333,0.6979166666666666
3686,2014,RJ,DEPUTADO ESTADUAL,PTB,69,24,93,0.25806451612903225,0.7419354838709677
3687,2014,RJ,DEPUTADO ESTADUAL,PEN,51,22,73,0.3013698630136986,0.6986301369863014
3688,2014,RJ,DEPUTADO ESTADUAL,PDT,51,24,75,0.32,0.68
3689,2014,RJ,DEPUTADO ESTADUAL,PSD,26,12,38,0.3157894736842105,0.6842105263157895
3690,2014,RJ,DEPUTADO ESTADUAL,PRP,43,19,62,0.3064516129032258,0.6935483870967742
3691,2014,RJ,DEPUTADO ESTADUAL,PCB,1,1,2,0.5,0.5
3692,2014,RJ,DEPUTADO FEDERAL,PSL,30,20,50,0.4,0.6
3693,2014,RJ,DEPUTADO FEDERAL,PT do B,49,21,70,0.3,0.7
3694,2014,RJ,DEPUTADO FEDERAL,PPS,16,2,18,0.1111111111111111,0.8888888888888888
3695,2014,RJ,DEPUTADO FEDERAL,PSOL,36,16,52,0.3076923076923077,0.6923076923076923
3696,2014,RJ,DEPUTADO FEDERAL,PSB,24,9,33,0.2727272727272727,0.7272727272727273
3697,2014,RJ,DEPUTADO FEDERAL,SD,33,9,42,0.21428571428571427,0.7857142857142857
3698,2014,RJ,DEPUTADO FEDERAL,PMDB,21,12,33,0.36363636363636365,0.6363636363636364
3699,2014,RJ,DEPUTADO FEDERAL,PT,31,15,46,0.32608695652173914,0.6739130434782609
3700,2014,RJ,DEPUTADO FEDERAL,PSTU,2,1,3,0.3333333333333333,0.6666666666666666
3701,2014,RJ,DEPUTADO FEDERAL,PDT,35,15,50,0.3,0.7
3702,2014,RJ,DEPUTADO FEDERAL,PTC,14,5,19,0.2631578947368421,0.7368421052631579
3703,2014,RJ,DEPUTADO FEDERAL,PSDC,41,18,59,0.3050847457627119,0.6949152542372882
3704,2014,RJ,DEPUTADO FEDERAL,PRB,47,20,67,0.29850746268656714,0.7014925373134329
3705,2014,RJ,DEPUTADO FEDERAL,PMN,10,6,16,0.375,0.625
3706,2014,RJ,DEPUTADO FEDERAL,PSD,16,5,21,0.23809523809523808,0.7619047619047619
3707,2014,RJ,DEPUTADO FEDERAL,DEM,22,9,31,0.2903225806451613,0.7096774193548387
3708,2014,RJ,DEPUTADO FEDERAL,PEN,38,19,57,0.3333333333333333,0.6666666666666666
3709,2014,RJ,DEPUTADO FEDERAL,PSDB,28,17,45,0.37777777777777777,0.6222222222222222
3710,2014,RJ,DEPUTADO FEDERAL,PR,49,26,75,0.3466666666666667,0.6533333333333333
3711,2014,RJ,DEPUTADO FEDERAL,PCB,6,5,11,0.45454545454545453,0.5454545454545454
3712,2014,RJ,DEPUTADO FEDERAL,PTB,7,4,11,0.36363636363636365,0.6363636363636364
3713,2014,RJ,DEPUTADO FEDERAL,PROS,8,1,9,0.1111111111111111,0.8888888888888888
3714,2014,RJ,DEPUTADO FEDERAL,PHS,56,24,80,0.3,0.7
3715,2014,RJ,DEPUTADO FEDERAL,PV,32,14,46,0.30434782608695654,0.6956521739130435
3716,2014,RJ,DEPUTADO FEDERAL,PSC,8,0,8,0.0,1.0
3717,2014,RJ,DEPUTADO FEDERAL,PRP,26,19,45,0.4222222222222222,0.5777777777777777
3718,2014,RJ,DEPUTADO FEDERAL,PRTB,35,7,42,0.16666666666666666,0.8333333333333334
3719,2014,RJ,DEPUTADO FEDERAL,PPL,3,1,4,0.25,0.75
3720,2014,RJ,DEPUTADO FEDERAL,PTN,9,4,13,0.3076923076923077,0.6923076923076923
3721,2014,RJ,DEPUTADO FEDERAL,PP,12,6,18,0.3333333333333333,0.6666666666666666
3722,2014,RJ,DEPUTADO FEDERAL,PC do B,4,2,6,0.3333333333333333,0.6666666666666666
3723,2014,RJ,DEPUTADO FEDERAL,PCO,1,0,1,0.0,1.0
3724,2014,RJ,SENADOR,PSB,1,0,1,0.0,1.0
3725,2014,RJ,SENADOR,PDT,1,0,1,0.0,1.0
3726,2014,RJ,SENADOR,PSTU,1,0,1,0.0,1.0
3727,2014,RJ,SENADOR,PRB,1,0,1,0.0,1.0
3728,2014,RJ,SENADOR,DEM,1,0,1,0.0,1.0
3729,2014,RJ,SENADOR,PCB,1,0,1,0.0,1.0
3730,2014,RJ,SENADOR,PSOL,1,0,1,0.0,1.0
3731,2014,RJ,SENADOR,PROS,0,1,1,1.0,0.0
3732,2018,RJ,DEPUTADO ESTADUAL,PATRI,67,32,99,0.32323232323232326,0.6767676767676768
3733,2018,RJ,DEPUTADO ESTADUAL,REDE,21,9,30,0.3,0.7
3734,2018,RJ,DEPUTADO ESTADUAL,PR,50,24,74,0.32432432432432434,0.6756756756756757
3735,2018,RJ,DEPUTADO ESTADUAL,PROS,73,32,105,0.3047619047619048,0.6952380952380952
3736,2018,RJ,DEPUTADO ESTADUAL,PSDB,45,18,63,0.2857142857142857,0.7142857142857143
3737,2018,RJ,DEPUTADO ESTADUAL,MDB,45,22,67,0.3283582089552239,0.6716417910447762
3738,2018,RJ,DEPUTADO ESTADUAL,PRP,73,32,105,0.3047619047619048,0.6952380952380952
3739,2018,RJ,DEPUTADO ESTADUAL,PMN,55,27,82,0.32926829268292684,0.6707317073170732
3740,2018,RJ,DEPUTADO ESTADUAL,PPS,21,12,33,0.36363636363636365,0.6363636363636364
3741,2018,RJ,DEPUTADO ESTADUAL,AVANTE,74,33,107,0.308411214953271,0.6915887850467289
3742,2018,RJ,DEPUTADO ESTADUAL,PTB,28,18,46,0.391304347826087,0.6086956521739131
3743,2018,RJ,DEPUTADO ESTADUAL,PHS,69,30,99,0.30303030303030304,0.696969696969697
3744,2018,RJ,DEPUTADO ESTADUAL,SOLIDARIEDADE,46,14,60,0.23333333333333334,0.7666666666666667
3745,2018,RJ,DEPUTADO ESTADUAL,PSD,63,27,90,0.3,0.7
3746,2018,RJ,DEPUTADO ESTADUAL,DC,46,20,66,0.30303030303030304,0.696969696969697
3747,2018,RJ,DEPUTADO ESTADUAL,PMB,73,32,105,0.3047619047619048,0.6952380952380952
3748,2018,RJ,DEPUTADO ESTADUAL,PRTB,65,28,93,0.3010752688172043,0.6989247311827957
3749,2018,RJ,DEPUTADO ESTADUAL,PC do B,64,28,92,0.30434782608695654,0.6956521739130435
3750,2018,RJ,DEPUTADO ESTADUAL,PDT,67,31,98,0.3163265306122449,0.6836734693877551
3751,2018,RJ,DEPUTADO ESTADUAL,PV,26,12,38,0.3157894736842105,0.6842105263157895
3752,2018,RJ,DEPUTADO ESTADUAL,PTC,73,32,105,0.3047619047619048,0.6952380952380952
3753,2018,RJ,DEPUTADO ESTADUAL,PT,36,17,53,0.32075471698113206,0.6792452830188679
3754,2018,RJ,DEPUTADO ESTADUAL,NOVO,19,9,28,0.32142857142857145,0.6785714285714286
3755,2018,RJ,DEPUTADO ESTADUAL,PSC,70,31,101,0.3069306930693069,0.693069306930693
3756,2018,RJ,DEPUTADO ESTADUAL,PRB,67,31,98,0.3163265306122449,0.6836734693877551
3757,2018,RJ,DEPUTADO ESTADUAL,PODE,51,23,74,0.3108108108108108,0.6891891891891891
3758,2018,RJ,DEPUTADO ESTADUAL,PP,53,23,76,0.3026315789473684,0.6973684210526315
3759,2018,RJ,DEPUTADO ESTADUAL,DEM,73,32,105,0.3047619047619048,0.6952380952380952
3760,2018,RJ,DEPUTADO ESTADUAL,PSL,70,32,102,0.3137254901960784,0.6862745098039216
3761,2018,RJ,DEPUTADO ESTADUAL,PSOL,36,17,53,0.32075471698113206,0.6792452830188679
3762,2018,RJ,DEPUTADO ESTADUAL,PSB,44,19,63,0.30158730158730157,0.6984126984126984
3763,2018,RJ,DEPUTADO ESTADUAL,PSTU,3,4,7,0.5714285714285714,0.42857142857142855
3764,2018,RJ,DEPUTADO ESTADUAL,PPL,20,10,30,0.3333333333333333,0.6666666666666666
3765,2018,RJ,DEPUTADO ESTADUAL,PCO,3,2,5,0.4,0.6
3766,2018,RJ,DEPUTADO ESTADUAL,PCB,1,0,1,0.0,1.0
3767,2018,RJ,DEPUTADO FEDERAL,NOVO,13,6,19,0.3157894736842105,0.6842105263157895
3768,2018,RJ,DEPUTADO FEDERAL,PODE,25,15,40,0.375,0.625
3769,2018,RJ,DEPUTADO FEDERAL,PSOL,33,15,48,0.3125,0.6875
3770,2018,RJ,DEPUTADO FEDERAL,PHS,47,21,68,0.3088235294117647,0.6911764705882353
3771,2018,RJ,DEPUTADO FEDERAL,PMB,26,14,40,0.35,0.65
3772,2018,RJ,DEPUTADO FEDERAL,PSL,48,21,69,0.30434782608695654,0.6956521739130435
3773,2018,RJ,DEPUTADO FEDERAL,PSD,43,19,62,0.3064516129032258,0.6935483870967742
3774,2018,RJ,DEPUTADO FEDERAL,SOLIDARIEDADE,24,10,34,0.29411764705882354,0.7058823529411765
3775,2018,RJ,DEPUTADO FEDERAL,PP,10,4,14,0.2857142857142857,0.7142857142857143
3776,2018,RJ,DEPUTADO FEDERAL,PSC,38,18,56,0.32142857142857145,0.6785714285714286
3777,2018,RJ,DEPUTADO FEDERAL,PRP,47,22,69,0.3188405797101449,0.6811594202898551
3778,2018,RJ,DEPUTADO FEDERAL,DEM,16,7,23,0.30434782608695654,0.6956521739130435
3779,2018,RJ,DEPUTADO FEDERAL,PMN,14,5,19,0.2631578947368421,0.7368421052631579
3780,2018,RJ,DEPUTADO FEDERAL,PSDB,14,7,21,0.3333333333333333,0.6666666666666666
3781,2018,RJ,DEPUTADO FEDERAL,PPS,10,4,14,0.2857142857142857,0.7142857142857143
3782,2018,RJ,DEPUTADO FEDERAL,MDB,14,7,21,0.3333333333333333,0.6666666666666666
3783,2018,RJ,DEPUTADO FEDERAL,PRB,43,18,61,0.29508196721311475,0.7049180327868853
3784,2018,RJ,DEPUTADO FEDERAL,DC,31,17,48,0.3541666666666667,0.6458333333333334
3785,2018,RJ,DEPUTADO FEDERAL,PPL,36,15,51,0.29411764705882354,0.7058823529411765
3786,2018,RJ,DEPUTADO FEDERAL,REDE,10,5,15,0.3333333333333333,0.6666666666666666
3787,2018,RJ,DEPUTADO FEDERAL,PRTB,38,17,55,0.3090909090909091,0.6909090909090909
3788,2018,RJ,DEPUTADO FEDERAL,PTB,11,3,14,0.21428571428571427,0.7857142857142857
3789,2018,RJ,DEPUTADO FEDERAL,PROS,10,3,13,0.23076923076923078,0.7692307692307693
3790,2018,RJ,DEPUTADO FEDERAL,PDT,34,19,53,0.3584905660377358,0.6415094339622641
3791,2018,RJ,DEPUTADO FEDERAL,PR,22,7,29,0.2413793103448276,0.7586206896551724
3792,2018,RJ,DEPUTADO FEDERAL,PTC,23,7,30,0.23333333333333334,0.7666666666666667
3793,2018,RJ,DEPUTADO FEDERAL,PT,17,8,25,0.32,0.68
3794,2018,RJ,DEPUTADO FEDERAL,PSB,15,3,18,0.16666666666666666,0.8333333333333334
3795,2018,RJ,DEPUTADO FEDERAL,AVANTE,33,16,49,0.32653061224489793,0.673469387755102
3796,2018,RJ,DEPUTADO FEDERAL,PC do B,6,3,9,0.3333333333333333,0.6666666666666666
3797,2018,RJ,DEPUTADO FEDERAL,PV,16,4,20,0.2,0.8
3798,2018,RJ,DEPUTADO FEDERAL,PCB,0,1,1,1.0,0.0
3799,2018,RJ,DEPUTADO FEDERAL,PSTU,1,0,1,0.0,1.0
3800,2018,RJ,DEPUTADO FEDERAL,PCO,1,1,2,0.5,0.5
3801,2018,RJ,SENADOR,PSL,1,0,1,0.0,1.0
3802,2018,RJ,SENADOR,PSTU,1,1,2,0.5,0.5
3803,2018,RJ,SENADOR,DEM,1,0,1,0.0,1.0
3804,2018,RJ,SENADOR,PSOL,1,0,1,0.0,1.0
3805,2018,RJ,SENADOR,PDT,1,0,1,0.0,1.0
3806,2018,RJ,SENADOR,PRB,1,0,1,0.0,1.0
3807,2018,RJ,SENADOR,PSC,1,0,1,0.0,1.0
3808,2018,RJ,SENADOR,PT,1,0,1,0.0,1.0
3809,2018,RJ,SENADOR,PMB,0,1,1,1.0,0.0
3810,2018,RJ,SENADOR,PATRI,1,0,1,0.0,1.0
3811,2018,RJ,SENADOR,PSD,1,0,1,0.0,1.0
3812,2018,RJ,SENADOR,PRTB,1,0,1,0.0,1.0
3813,2018,RJ,SENADOR,PSDB,0,1,1,1.0,0.0
3814,2018,RJ,SENADOR,PCO,1,0,1,0.0,1.0
3815,2018,RJ,SENADOR,REDE,1,0,1,0.0,1.0
3816,2018,RJ,SENADOR,PCB,0,1,1,1.0,0.0
3817,2010,RN,DEPUTADO ESTADUAL,PMDB,10,0,10,0.0,1.0
3818,2010,RN,DEPUTADO ESTADUAL,PR,10,1,11,0.09090909090909091,0.9090909090909091
3819,2010,RN,DEPUTADO ESTADUAL,PDT,9,1,10,0.1,0.9
3820,2010,RN,DEPUTADO ESTADUAL,PTC,5,0,5,0.0,1.0
3821,2010,RN,DEPUTADO ESTADUAL,PT,10,6,16,0.375,0.625
3822,2010,RN,DEPUTADO ESTADUAL,PCB,1,1,2,0.5,0.5
3823,2010,RN,DEPUTADO ESTADUAL,PSB,8,5,13,0.38461538461538464,0.6153846153846154
3824,2010,RN,DEPUTADO ESTADUAL,PRB,5,0,5,0.0,1.0
3825,2010,RN,DEPUTADO ESTADUAL,PSDB,8,0,8,0.0,1.0
3826,2010,RN,DEPUTADO ESTADUAL,PMN,5,2,7,0.2857142857142857,0.7142857142857143
3827,2010,RN,DEPUTADO ESTADUAL,PHS,10,4,14,0.2857142857142857,0.7142857142857143
3828,2010,RN,DEPUTADO ESTADUAL,PSDC,6,5,11,0.45454545454545453,0.5454545454545454
3829,2010,RN,DEPUTADO ESTADUAL,PPS,2,2,4,0.5,0.5
3830,2010,RN,DEPUTADO ESTADUAL,PP,3,0,3,0.0,1.0
3831,2010,RN,DEPUTADO ESTADUAL,DEM,8,0,8,0.0,1.0
3832,2010,RN,DEPUTADO ESTADUAL,PC do B,7,2,9,0.2222222222222222,0.7777777777777778
3833,2010,RN,DEPUTADO ESTADUAL,PV,7,3,10,0.3,0.7
3834,2010,RN,DEPUTADO ESTADUAL,PTB,2,0,2,0.0,1.0
3835,2010,RN,DEPUTADO ESTADUAL,PSL,2,0,2,0.0,1.0
3836,2010,RN,DEPUTADO ESTADUAL,PSOL,4,1,5,0.2,0.8
3837,2010,RN,DEPUTADO ESTADUAL,PRP,2,0,2,0.0,1.0
3838,2010,RN,DEPUTADO FEDERAL,PSB,2,3,5,0.6,0.4
3839,2010,RN,DEPUTADO FEDERAL,PSOL,4,0,4,0.0,1.0
3840,2010,RN,DEPUTADO FEDERAL,PHS,2,1,3,0.3333333333333333,0.6666666666666666
3841,2010,RN,DEPUTADO FEDERAL,PTC,3,0,3,0.0,1.0
3842,2010,RN,DEPUTADO FEDERAL,PSDB,4,0,4,0.0,1.0
3843,2010,RN,DEPUTADO FEDERAL,PV,7,1,8,0.125,0.875
3844,2010,RN,DEPUTADO FEDERAL,DEM,2,0,2,0.0,1.0
3845,2010,RN,DEPUTADO FEDERAL,PSL,1,0,1,0.0,1.0
3846,2010,RN,DEPUTADO FEDERAL,PRB,2,0,2,0.0,1.0
3847,2010,RN,DEPUTADO FEDERAL,PCB,2,0,2,0.0,1.0
3848,2010,RN,DEPUTADO FEDERAL,PT,2,2,4,0.5,0.5
3849,2010,RN,DEPUTADO FEDERAL,PC do B,4,0,4,0.0,1.0
3850,2010,RN,DEPUTADO FEDERAL,PMN,1,0,1,0.0,1.0
3851,2010,RN,DEPUTADO FEDERAL,PMDB,4,1,5,0.2,0.8
3852,2010,RN,DEPUTADO FEDERAL,PSDC,3,1,4,0.25,0.75
3853,2010,RN,DEPUTADO FEDERAL,PR,1,0,1,0.0,1.0
3854,2010,RN,DEPUTADO FEDERAL,PDT,2,0,2,0.0,1.0
3855,2010,RN,DEPUTADO FEDERAL,PTB,1,1,2,0.5,0.5
3856,2010,RN,DEPUTADO FEDERAL,PP,1,0,1,0.0,1.0
3857,2010,RN,DEPUTADO FEDERAL,PRP,1,0,1,0.0,1.0
3858,2010,RN,DEPUTADO FEDERAL,PSC,1,0,1,0.0,1.0
3859,2010,RN,DEPUTADO FEDERAL,PPS,1,0,1,0.0,1.0
3860,2010,RN,SENADOR,PSOL,1,0,1,0.0,1.0
3861,2010,RN,SENADOR,PMDB,1,0,1,0.0,1.0
3862,2010,RN,SENADOR,PT,1,0,1,0.0,1.0
3863,2010,RN,SENADOR,PSDC,1,0,1,0.0,1.0
3864,2010,RN,SENADOR,DEM,1,0,1,0.0,1.0
3865,2010,RN,SENADOR,PC do B,1,0,1,0.0,1.0
3866,2010,RN,SENADOR,PSB,0,1,1,1.0,0.0
3867,2014,RN,DEPUTADO ESTADUAL,PT,16,6,22,0.2727272727272727,0.7272727272727273
3868,2014,RN,DEPUTADO ESTADUAL,PEN,7,4,11,0.36363636363636365,0.6363636363636364
3869,2014,RN,DEPUTADO ESTADUAL,PSOL,16,7,23,0.30434782608695654,0.6956521739130435
3870,2014,RN,DEPUTADO ESTADUAL,PT do B,3,2,5,0.4,0.6
3871,2014,RN,DEPUTADO ESTADUAL,PSD,8,5,13,0.38461538461538464,0.6153846153846154
3872,2014,RN,DEPUTADO ESTADUAL,PMN,8,8,16,0.5,0.5
3873,2014,RN,DEPUTADO ESTADUAL,PMDB,10,8,18,0.4444444444444444,0.5555555555555556
3874,2014,RN,DEPUTADO ESTADUAL,PSB,3,2,5,0.4,0.6
3875,2014,RN,DEPUTADO ESTADUAL,PRB,5,3,8,0.375,0.625
3876,2014,RN,DEPUTADO ESTADUAL,PSDB,6,3,9,0.3333333333333333,0.6666666666666666
3877,2014,RN,DEPUTADO ESTADUAL,PROS,8,2,10,0.2,0.8
3878,2014,RN,DEPUTADO ESTADUAL,PV,11,6,17,0.35294117647058826,0.6470588235294118
3879,2014,RN,DEPUTADO ESTADUAL,PSDC,9,3,12,0.25,0.75
3880,2014,RN,DEPUTADO ESTADUAL,DEM,5,1,6,0.16666666666666666,0.8333333333333334
3881,2014,RN,DEPUTADO ESTADUAL,PDT,5,1,6,0.16666666666666666,0.8333333333333334
3882,2014,RN,DEPUTADO ESTADUAL,PP,5,2,7,0.2857142857142857,0.7142857142857143
3883,2014,RN,DEPUTADO ESTADUAL,PTC,7,3,10,0.3,0.7
3884,2014,RN,DEPUTADO ESTADUAL,PC do B,14,7,21,0.3333333333333333,0.6666666666666666
3885,2014,RN,DEPUTADO ESTADUAL,SD,1,1,2,0.5,0.5
3886,2014,RN,DEPUTADO ESTADUAL,PSTU,3,3,6,0.5,0.5
3887,2014,RN,DEPUTADO ESTADUAL,PRP,6,1,7,0.14285714285714285,0.8571428571428571
3888,2014,RN,DEPUTADO ESTADUAL,PRTB,2,0,2,0.0,1.0
3889,2014,RN,DEPUTADO ESTADUAL,PSC,5,1,6,0.16666666666666666,0.8333333333333334
3890,2014,RN,DEPUTADO ESTADUAL,PPS,1,2,3,0.6666666666666666,0.3333333333333333
3891,2014,RN,DEPUTADO ESTADUAL,PHS,12,7,19,0.3684210526315789,0.631578947368421
3892,2014,RN,DEPUTADO ESTADUAL,PR,2,1,3,0.3333333333333333,0.6666666666666666
3893,2014,RN,DEPUTADO ESTADUAL,PSL,1,2,3,0.6666666666666666,0.3333333333333333
3894,2014,RN,DEPUTADO ESTADUAL,PTB,3,0,3,0.0,1.0
3895,2014,RN,DEPUTADO ESTADUAL,PTN,0,1,1,1.0,0.0
3896,2014,RN,DEPUTADO FEDERAL,PP,4,1,5,0.2,0.8
3897,2014,RN,DEPUTADO FEDERAL,PTC,6,3,9,0.3333333333333333,0.6666666666666666
3898,2014,RN,DEPUTADO FEDERAL,PC do B,3,1,4,0.25,0.75
3899,2014,RN,DEPUTADO FEDERAL,PHS,5,4,9,0.4444444444444444,0.5555555555555556
3900,2014,RN,DEPUTADO FEDERAL,PRB,2,0,2,0.0,1.0
3901,2014,RN,DEPUTADO FEDERAL,PSOL,9,4,13,0.3076923076923077,0.6923076923076923
3902,2014,RN,DEPUTADO FEDERAL,PR,0,1,1,1.0,0.0
3903,2014,RN,DEPUTADO FEDERAL,PTN,2,1,3,0.3333333333333333,0.6666666666666666
3904,2014,RN,DEPUTADO FEDERAL,PSTU,3,2,5,0.4,0.6
3905,2014,RN,DEPUTADO FEDERAL,PV,1,0,1,0.0,1.0
3906,2014,RN,DEPUTADO FEDERAL,PSB,1,1,2,0.5,0.5
3907,2014,RN,DEPUTADO FEDERAL,PSC,2,0,2,0.0,1.0
3908,2014,RN,DEPUTADO FEDERAL,PSDC,2,1,3,0.3333333333333333,0.6666666666666666
3909,2014,RN,DEPUTADO FEDERAL,PTB,2,1,3,0.3333333333333333,0.6666666666666666
3910,2014,RN,DEPUTADO FEDERAL,PSD,3,2,5,0.4,0.6
3911,2014,RN,DEPUTADO FEDERAL,PT,6,1,7,0.14285714285714285,0.8571428571428571
3912,2014,RN,DEPUTADO FEDERAL,PSL,3,3,6,0.5,0.5
3913,2014,RN,DEPUTADO FEDERAL,PMDB,2,1,3,0.3333333333333333,0.6666666666666666
3914,2014,RN,DEPUTADO FEDERAL,DEM,1,0,1,0.0,1.0
3915,2014,RN,DEPUTADO FEDERAL,PDT,2,1,3,0.3333333333333333,0.6666666666666666
3916,2014,RN,DEPUTADO FEDERAL,PMN,1,0,1,0.0,1.0
3917,2014,RN,DEPUTADO FEDERAL,PROS,1,2,3,0.6666666666666666,0.3333333333333333
3918,2014,RN,DEPUTADO FEDERAL,PPS,2,0,2,0.0,1.0
3919,2014,RN,DEPUTADO FEDERAL,SD,1,0,1,0.0,1.0
3920,2014,RN,DEPUTADO FEDERAL,PEN,1,2,3,0.6666666666666666,0.3333333333333333
3921,2014,RN,DEPUTADO FEDERAL,PSDB,1,0,1,0.0,1.0
3922,2014,RN,DEPUTADO FEDERAL,PRP,1,0,1,0.0,1.0
3923,2014,RN,DEPUTADO FEDERAL,PRTB,1,0,1,0.0,1.0
3924,2014,RN,SENADOR,PSOL,1,0,1,0.0,1.0
3925,2014,RN,SENADOR,PSL,1,0,1,0.0,1.0
3926,2014,RN,SENADOR,PSB,0,1,1,1.0,0.0
3927,2014,RN,SENADOR,PSTU,0,1,1,1.0,0.0
3928,2014,RN,SENADOR,PT,0,1,1,1.0,0.0
3929,2018,RN,DEPUTADO ESTADUAL,PRB,17,8,25,0.32,0.68
3930,2018,RN,DEPUTADO ESTADUAL,PT,13,6,19,0.3157894736842105,0.6842105263157895
3931,2018,RN,DEPUTADO ESTADUAL,PSB,3,4,7,0.5714285714285714,0.42857142857142855
3932,2018,RN,DEPUTADO ESTADUAL,AVANTE,15,7,22,0.3181818181818182,0.6818181818181818
3933,2018,RN,DEPUTADO ESTADUAL,PMB,11,3,14,0.21428571428571427,0.7857142857142857
3934,2018,RN,DEPUTADO ESTADUAL,PSOL,19,11,30,0.36666666666666664,0.6333333333333333
3935,2018,RN,DEPUTADO ESTADUAL,DC,7,6,13,0.46153846153846156,0.5384615384615384
3936,2018,RN,DEPUTADO ESTADUAL,PC do B,13,5,18,0.2777777777777778,0.7222222222222222
3937,2018,RN,DEPUTADO ESTADUAL,PSD,9,2,11,0.18181818181818182,0.8181818181818182
3938,2018,RN,DEPUTADO ESTADUAL,PSC,9,2,11,0.18181818181818182,0.8181818181818182
3939,2018,RN,DEPUTADO ESTADUAL,PSDB,7,3,10,0.3,0.7
3940,2018,RN,DEPUTADO ESTADUAL,PSL,11,5,16,0.3125,0.6875
3941,2018,RN,DEPUTADO ESTADUAL,SOLIDARIEDADE,27,11,38,0.2894736842105263,0.7105263157894737
3942,2018,RN,DEPUTADO ESTADUAL,PATRI,3,2,5,0.4,0.6
3943,2018,RN,DEPUTADO ESTADUAL,PV,7,5,12,0.4166666666666667,0.5833333333333334
3944,2018,RN,DEPUTADO ESTADUAL,PTB,2,0,2,0.0,1.0
3945,2018,RN,DEPUTADO ESTADUAL,PSTU,1,1,2,0.5,0.5
3946,2018,RN,DEPUTADO ESTADUAL,PHS,5,5,10,0.5,0.5
3947,2018,RN,DEPUTADO ESTADUAL,MDB,4,1,5,0.2,0.8
3948,2018,RN,DEPUTADO ESTADUAL,PP,2,2,4,0.5,0.5
3949,2018,RN,DEPUTADO ESTADUAL,PPL,2,1,3,0.3333333333333333,0.6666666666666666
3950,2018,RN,DEPUTADO ESTADUAL,REDE,9,4,13,0.3076923076923077,0.6923076923076923
3951,2018,RN,DEPUTADO ESTADUAL,PRTB,3,2,5,0.4,0.6
3952,2018,RN,DEPUTADO ESTADUAL,PR,4,1,5,0.2,0.8
3953,2018,RN,DEPUTADO ESTADUAL,PCO,1,0,1,0.0,1.0
3954,2018,RN,DEPUTADO ESTADUAL,PRP,1,1,2,0.5,0.5
3955,2018,RN,DEPUTADO ESTADUAL,PTC,2,3,5,0.6,0.4
3956,2018,RN,DEPUTADO ESTADUAL,PODE,5,1,6,0.16666666666666666,0.8333333333333334
3957,2018,RN,DEPUTADO ESTADUAL,PPS,0,1,1,1.0,0.0
3958,2018,RN,DEPUTADO ESTADUAL,DEM,3,1,4,0.25,0.75
3959,2018,RN,DEPUTADO ESTADUAL,PDT,2,3,5,0.6,0.4
3960,2018,RN,DEPUTADO ESTADUAL,PROS,2,1,3,0.3333333333333333,0.6666666666666666
3961,2018,RN,DEPUTADO FEDERAL,PSD,2,2,4,0.5,0.5
3962,2018,RN,DEPUTADO FEDERAL,SOLIDARIEDADE,6,5,11,0.45454545454545453,0.5454545454545454
3963,2018,RN,DEPUTADO FEDERAL,PTC,1,0,1,0.0,1.0
3964,2018,RN,DEPUTADO FEDERAL,PATRI,7,5,12,0.4166666666666667,0.5833333333333334
3965,2018,RN,DEPUTADO FEDERAL,PDT,3,1,4,0.25,0.75
3966,2018,RN,DEPUTADO FEDERAL,PSOL,8,4,12,0.3333333333333333,0.6666666666666666
3967,2018,RN,DEPUTADO FEDERAL,NOVO,3,2,5,0.4,0.6
3968,2018,RN,DEPUTADO FEDERAL,PC do B,4,2,6,0.3333333333333333,0.6666666666666666
3969,2018,RN,DEPUTADO FEDERAL,PRTB,9,5,14,0.35714285714285715,0.6428571428571429
3970,2018,RN,DEPUTADO FEDERAL,PMN,1,0,1,0.0,1.0
3971,2018,RN,DEPUTADO FEDERAL,REDE,2,1,3,0.3333333333333333,0.6666666666666666
3972,2018,RN,DEPUTADO FEDERAL,PT,4,2,6,0.3333333333333333,0.6666666666666666
3973,2018,RN,DEPUTADO FEDERAL,PSC,2,0,2,0.0,1.0
3974,2018,RN,DEPUTADO FEDERAL,PROS,0,1,1,1.0,0.0
3975,2018,RN,DEPUTADO FEDERAL,PPL,4,0,4,0.0,1.0
3976,2018,RN,DEPUTADO FEDERAL,PODE,2,2,4,0.5,0.5
3977,2018,RN,DEPUTADO FEDERAL,PP,2,1,3,0.3333333333333333,0.6666666666666666
3978,2018,RN,DEPUTADO FEDERAL,PHS,2,2,4,0.5,0.5
3979,2018,RN,DEPUTADO FEDERAL,PSDB,1,0,1,0.0,1.0
3980,2018,RN,DEPUTADO FEDERAL,AVANTE,1,1,2,0.5,0.5
3981,2018,RN,DEPUTADO FEDERAL,PRB,1,1,2,0.5,0.5
3982,2018,RN,DEPUTADO FEDERAL,PSB,1,0,1,0.0,1.0
3983,2018,RN,DEPUTADO FEDERAL,MDB,2,2,4,0.5,0.5
3984,2018,RN,DEPUTADO FEDERAL,PCO,1,0,1,0.0,1.0
3985,2018,RN,DEPUTADO FEDERAL,PPS,1,0,1,0.0,1.0
3986,2018,RN,DEPUTADO FEDERAL,PSL,1,0,1,0.0,1.0
3987,2018,RN,DEPUTADO FEDERAL,DEM,1,0,1,0.0,1.0
3988,2018,RN,DEPUTADO FEDERAL,PMB,2,0,2,0.0,1.0
3989,2018,RN,DEPUTADO FEDERAL,PSTU,1,0,1,0.0,1.0
3990,2018,RN,DEPUTADO FEDERAL,PV,1,0,1,0.0,1.0
3991,2018,RN,DEPUTADO FEDERAL,PRP,1,1,2,0.5,0.5
3992,2018,RN,DEPUTADO FEDERAL,PTB,1,0,1,0.0,1.0
3993,2018,RN,DEPUTADO FEDERAL,DC,1,0,1,0.0,1.0
3994,2018,RN,DEPUTADO FEDERAL,PR,1,0,1,0.0,1.0
3995,2018,RN,SENADOR,PSOL,1,1,2,0.5,0.5
3996,2018,RN,SENADOR,PRTB,2,0,2,0.0,1.0
3997,2018,RN,SENADOR,REDE,2,0,2,0.0,1.0
3998,2018,RN,SENADOR,PSDB,1,0,1,0.0,1.0
3999,2018,RN,SENADOR,MDB,1,0,1,0.0,1.0
4000,2018,RN,SENADOR,SOLIDARIEDADE,0,1,1,1.0,0.0
4001,2018,RN,SENADOR,PSTU,1,1,2,0.5,0.5
4002,2018,RN,SENADOR,PT,1,0,1,0.0,1.0
4003,2018,RN,SENADOR,DC,1,0,1,0.0,1.0
4004,2018,RN,SENADOR,PODE,1,0,1,0.0,1.0
4005,2018,RN,SENADOR,PHS,0,1,1,1.0,0.0
4006,2010,RS,DEPUTADO ESTADUAL,PSDB,37,12,49,0.24489795918367346,0.7551020408163265
4007,2010,RS,DEPUTADO ESTADUAL,DEM,27,11,38,0.2894736842105263,0.7105263157894737
4008,2010,RS,DEPUTADO ESTADUAL,PSB,24,10,34,0.29411764705882354,0.7058823529411765
4009,2010,RS,DEPUTADO ESTADUAL,PTC,17,2,19,0.10526315789473684,0.8947368421052632
4010,2010,RS,DEPUTADO ESTADUAL,PP,21,9,30,0.3,0.7
4011,2010,RS,DEPUTADO ESTADUAL,PHS,1,3,4,0.75,0.25
4012,2010,RS,DEPUTADO ESTADUAL,PMN,2,1,3,0.3333333333333333,0.6666666666666666
4013,2010,RS,DEPUTADO ESTADUAL,PTB,49,18,67,0.26865671641791045,0.7313432835820896
4014,2010,RS,DEPUTADO ESTADUAL,PDT,48,15,63,0.23809523809523808,0.7619047619047619
4015,2010,RS,DEPUTADO ESTADUAL,PT,60,25,85,0.29411764705882354,0.7058823529411765
4016,2010,RS,DEPUTADO ESTADUAL,PSOL,27,14,41,0.34146341463414637,0.6585365853658537
4017,2010,RS,DEPUTADO ESTADUAL,PMDB,43,17,60,0.2833333333333333,0.7166666666666667
4018,2010,RS,DEPUTADO ESTADUAL,PT do B,10,3,13,0.23076923076923078,0.7692307692307693
4019,2010,RS,DEPUTADO ESTADUAL,PPS,9,2,11,0.18181818181818182,0.8181818181818182
4020,2010,RS,DEPUTADO ESTADUAL,PV,27,13,40,0.325,0.675
4021,2010,RS,DEPUTADO ESTADUAL,PC do B,19,9,28,0.32142857142857145,0.6785714285714286
4022,2010,RS,DEPUTADO ESTADUAL,PSTU,0,1,1,1.0,0.0
4023,2010,RS,DEPUTADO ESTADUAL,PRP,4,2,6,0.3333333333333333,0.6666666666666666
4024,2010,RS,DEPUTADO ESTADUAL,PSC,7,3,10,0.3,0.7
4025,2010,RS,DEPUTADO ESTADUAL,PRB,12,1,13,0.07692307692307693,0.9230769230769231
4026,2010,RS,DEPUTADO ESTADUAL,PSDC,2,0,2,0.0,1.0
4027,2010,RS,DEPUTADO ESTADUAL,PTN,1,0,1,0.0,1.0
4028,2010,RS,DEPUTADO ESTADUAL,PR,4,1,5,0.2,0.8
4029,2010,RS,DEPUTADO ESTADUAL,PRTB,1,0,1,0.0,1.0
4030,2010,RS,DEPUTADO ESTADUAL,PCB,1,0,1,0.0,1.0
4031,2010,RS,DEPUTADO ESTADUAL,PSL,1,0,1,0.0,1.0
4032,2010,RS,DEPUTADO FEDERAL,PSDB,16,6,22,0.2727272727272727,0.7272727272727273
4033,2010,RS,DEPUTADO FEDERAL,PDT,22,7,29,0.2413793103448276,0.7586206896551724
4034,2010,RS,DEPUTADO FEDERAL,PP,13,6,19,0.3157894736842105,0.6842105263157895
4035,2010,RS,DEPUTADO FEDERAL,DEM,10,3,13,0.23076923076923078,0.7692307692307693
4036,2010,RS,DEPUTADO FEDERAL,PMDB,21,9,30,0.3,0.7
4037,2010,RS,DEPUTADO FEDERAL,PSOL,26,12,38,0.3157894736842105,0.6842105263157895
4038,2010,RS,DEPUTADO FEDERAL,PV,27,6,33,0.18181818181818182,0.8181818181818182
4039,2010,RS,DEPUTADO FEDERAL,PTC,8,0,8,0.0,1.0
4040,2010,RS,DEPUTADO FEDERAL,PSB,15,8,23,0.34782608695652173,0.6521739130434783
4041,2010,RS,DEPUTADO FEDERAL,PTB,16,8,24,0.3333333333333333,0.6666666666666666
4042,2010,RS,DEPUTADO FEDERAL,PMN,10,3,13,0.23076923076923078,0.7692307692307693
4043,2010,RS,DEPUTADO FEDERAL,PC do B,9,4,13,0.3076923076923077,0.6923076923076923
4044,2010,RS,DEPUTADO FEDERAL,PPS,6,1,7,0.14285714285714285,0.8571428571428571
4045,2010,RS,DEPUTADO FEDERAL,PSC,2,1,3,0.3333333333333333,0.6666666666666666
4046,2010,RS,DEPUTADO FEDERAL,PR,2,1,3,0.3333333333333333,0.6666666666666666
4047,2010,RS,DEPUTADO FEDERAL,PT,15,5,20,0.25,0.75
4048,2010,RS,DEPUTADO FEDERAL,PCB,1,0,1,0.0,1.0
4049,2010,RS,DEPUTADO FEDERAL,PSDC,2,1,3,0.3333333333333333,0.6666666666666666
4050,2010,RS,DEPUTADO FEDERAL,PHS,2,0,2,0.0,1.0
4051,2010,RS,DEPUTADO FEDERAL,PSTU,2,1,3,0.3333333333333333,0.6666666666666666
4052,2010,RS,DEPUTADO FEDERAL,PT do B,1,0,1,0.0,1.0
4053,2010,RS,DEPUTADO FEDERAL,PTN,1,0,1,0.0,1.0
4054,2010,RS,DEPUTADO FEDERAL,PRP,2,1,3,0.3333333333333333,0.6666666666666666
4055,2010,RS,DEPUTADO FEDERAL,PSL,1,0,1,0.0,1.0
4056,2010,RS,DEPUTADO FEDERAL,PRB,1,0,1,0.0,1.0
4057,2010,RS,SENADOR,PP,0,1,1,1.0,0.0
4058,2010,RS,SENADOR,PSOL,1,1,2,0.5,0.5
4059,2010,RS,SENADOR,PC do B,0,1,1,1.0,0.0
4060,2010,RS,SENADOR,PMDB,1,0,1,0.0,1.0
4061,2010,RS,SENADOR,PMN,1,0,1,0.0,1.0
4062,2010,RS,SENADOR,PCB,2,0,2,0.0,1.0
4063,2010,RS,SENADOR,PV,1,0,1,0.0,1.0
4064,2010,RS,SENADOR,PT,1,0,1,0.0,1.0
4065,2010,RS,SENADOR,PTC,1,0,1,0.0,1.0
4066,2010,RS,SENADOR,PSTU,0,1,1,1.0,0.0
4067,2014,RS,DEPUTADO ESTADUAL,PT,46,19,65,0.2923076923076923,0.7076923076923077
4068,2014,RS,DEPUTADO ESTADUAL,PT do B,14,9,23,0.391304347826087,0.6086956521739131
4069,2014,RS,DEPUTADO ESTADUAL,PSDC,5,4,9,0.4444444444444444,0.5555555555555556
4070,2014,RS,DEPUTADO ESTADUAL,PSC,23,11,34,0.3235294117647059,0.6764705882352942
4071,2014,RS,DEPUTADO ESTADUAL,PHS,1,2,3,0.6666666666666666,0.3333333333333333
4072,2014,RS,DEPUTADO ESTADUAL,PSD,15,2,17,0.11764705882352941,0.8823529411764706
4073,2014,RS,DEPUTADO ESTADUAL,PRTB,7,3,10,0.3,0.7
4074,2014,RS,DEPUTADO ESTADUAL,PSB,42,19,61,0.3114754098360656,0.6885245901639344
4075,2014,RS,DEPUTADO ESTADUAL,PMDB,41,20,61,0.32786885245901637,0.6721311475409836
4076,2014,RS,DEPUTADO ESTADUAL,DEM,10,5,15,0.3333333333333333,0.6666666666666666
4077,2014,RS,DEPUTADO ESTADUAL,PP,40,18,58,0.3103448275862069,0.6896551724137931
4078,2014,RS,DEPUTADO ESTADUAL,PTB,33,18,51,0.35294117647058826,0.6470588235294118
4079,2014,RS,DEPUTADO ESTADUAL,PEN,18,7,25,0.28,0.72
4080,2014,RS,DEPUTADO ESTADUAL,PSL,13,4,17,0.23529411764705882,0.7647058823529411
4081,2014,RS,DEPUTADO ESTADUAL,PC do B,19,8,27,0.2962962962962963,0.7037037037037037
4082,2014,RS,DEPUTADO ESTADUAL,PTC,6,3,9,0.3333333333333333,0.6666666666666666
4083,2014,RS,DEPUTADO ESTADUAL,PPL,16,7,23,0.30434782608695654,0.6956521739130435
4084,2014,RS,DEPUTADO ESTADUAL,PR,9,4,13,0.3076923076923077,0.6923076923076923
4085,2014,RS,DEPUTADO ESTADUAL,PV,33,14,47,0.2978723404255319,0.7021276595744681
4086,2014,RS,DEPUTADO ESTADUAL,PPS,4,1,5,0.2,0.8
4087,2014,RS,DEPUTADO ESTADUAL,PRB,12,6,18,0.3333333333333333,0.6666666666666666
4088,2014,RS,DEPUTADO ESTADUAL,PSDB,16,8,24,0.3333333333333333,0.6666666666666666
4089,2014,RS,DEPUTADO ESTADUAL,SD,16,5,21,0.23809523809523808,0.7619047619047619
4090,2014,RS,DEPUTADO ESTADUAL,PSOL,19,10,29,0.3448275862068966,0.6551724137931034
4091,2014,RS,DEPUTADO ESTADUAL,PDT,27,14,41,0.34146341463414637,0.6585365853658537
4092,2014,RS,DEPUTADO ESTADUAL,PMN,3,2,5,0.4,0.6
4093,2014,RS,DEPUTADO ESTADUAL,PROS,3,1,4,0.25,0.75
4094,2014,RS,DEPUTADO ESTADUAL,PSTU,2,1,3,0.3333333333333333,0.6666666666666666
4095,2014,RS,DEPUTADO ESTADUAL,PCB,1,0,1,0.0,1.0
4096,2014,RS,DEPUTADO ESTADUAL,PRP,1,1,2,0.5,0.5
4097,2014,RS,DEPUTADO FEDERAL,PSC,9,5,14,0.35714285714285715,0.6428571428571429
4098,2014,RS,DEPUTADO FEDERAL,PDT,17,8,25,0.32,0.68
4099,2014,RS,DEPUTADO FEDERAL,PMDB,21,9,30,0.3,0.7
4100,2014,RS,DEPUTADO FEDERAL,PSOL,24,11,35,0.3142857142857143,0.6857142857142857
4101,2014,RS,DEPUTADO FEDERAL,PT,13,6,19,0.3157894736842105,0.6842105263157895
4102,2014,RS,DEPUTADO FEDERAL,PP,18,8,26,0.3076923076923077,0.6923076923076923
4103,2014,RS,DEPUTADO FEDERAL,PSDB,12,6,18,0.3333333333333333,0.6666666666666666
4104,2014,RS,DEPUTADO FEDERAL,PV,1,2,3,0.6666666666666666,0.3333333333333333
4105,2014,RS,DEPUTADO FEDERAL,PMN,3,2,5,0.4,0.6
4106,2014,RS,DEPUTADO FEDERAL,PSB,24,11,35,0.3142857142857143,0.6857142857142857
4107,2014,RS,DEPUTADO FEDERAL,PPS,6,2,8,0.25,0.75
4108,2014,RS,DEPUTADO FEDERAL,PC do B,6,6,12,0.5,0.5
4109,2014,RS,DEPUTADO FEDERAL,DEM,2,1,3,0.3333333333333333,0.6666666666666666
4110,2014,RS,DEPUTADO FEDERAL,PPL,1,1,2,0.5,0.5
4111,2014,RS,DEPUTADO FEDERAL,PTB,18,3,21,0.14285714285714285,0.8571428571428571
4112,2014,RS,DEPUTADO FEDERAL,PEN,10,6,16,0.375,0.625
4113,2014,RS,DEPUTADO FEDERAL,PRP,4,2,6,0.3333333333333333,0.6666666666666666
4114,2014,RS,DEPUTADO FEDERAL,PSD,6,0,6,0.0,1.0
4115,2014,RS,DEPUTADO FEDERAL,PRTB,10,5,15,0.3333333333333333,0.6666666666666666
4116,2014,RS,DEPUTADO FEDERAL,PR,1,1,2,0.5,0.5
4117,2014,RS,DEPUTADO FEDERAL,PSTU,3,2,5,0.4,0.6
4118,2014,RS,DEPUTADO FEDERAL,PHS,2,5,7,0.7142857142857143,0.2857142857142857
4119,2014,RS,DEPUTADO FEDERAL,PT do B,1,0,1,0.0,1.0
4120,2014,RS,DEPUTADO FEDERAL,PROS,2,1,3,0.3333333333333333,0.6666666666666666
4121,2014,RS,DEPUTADO FEDERAL,PRB,2,1,3,0.3333333333333333,0.6666666666666666
4122,2014,RS,DEPUTADO FEDERAL,PSL,2,0,2,0.0,1.0
4123,2014,RS,DEPUTADO FEDERAL,PCB,1,0,1,0.0,1.0
4124,2014,RS,DEPUTADO FEDERAL,SD,1,0,1,0.0,1.0
4125,2014,RS,DEPUTADO FEDERAL,PTC,2,1,3,0.3333333333333333,0.6666666666666666
4126,2014,RS,SENADOR,PT,1,0,1,0.0,1.0
4127,2014,RS,SENADOR,PRP,1,0,1,0.0,1.0
4128,2014,RS,SENADOR,PSTU,1,0,1,0.0,1.0
4129,2014,RS,SENADOR,PSB,1,0,1,0.0,1.0
4130,2014,RS,SENADOR,PP,0,1,1,1.0,0.0
4131,2014,RS,SENADOR,PMN,1,0,1,0.0,1.0
4132,2014,RS,SENADOR,PMDB,1,0,1,0.0,1.0
4133,2014,RS,SENADOR,PDT,1,0,1,0.0,1.0
4134,2018,RS,DEPUTADO ESTADUAL,PSDB,23,10,33,0.30303030303030304,0.696969696969697
4135,2018,RS,DEPUTADO ESTADUAL,PDT,35,16,51,0.3137254901960784,0.6862745098039216
4136,2018,RS,DEPUTADO ESTADUAL,PROS,39,17,56,0.30357142857142855,0.6964285714285714
4137,2018,RS,DEPUTADO ESTADUAL,SOLIDARIEDADE,43,22,65,0.3384615384615385,0.6615384615384615
4138,2018,RS,DEPUTADO ESTADUAL,PT,30,13,43,0.3023255813953488,0.6976744186046512
4139,2018,RS,DEPUTADO ESTADUAL,REDE,12,5,17,0.29411764705882354,0.7058823529411765
4140,2018,RS,DEPUTADO ESTADUAL,PP,31,16,47,0.3404255319148936,0.6595744680851063
4141,2018,RS,DEPUTADO ESTADUAL,PC do B,15,8,23,0.34782608695652173,0.6521739130434783
4142,2018,RS,DEPUTADO ESTADUAL,PMB,2,1,3,0.3333333333333333,0.6666666666666666
4143,2018,RS,DEPUTADO ESTADUAL,PSL,25,10,35,0.2857142857142857,0.7142857142857143
4144,2018,RS,DEPUTADO ESTADUAL,DEM,15,8,23,0.34782608695652173,0.6521739130434783
4145,2018,RS,DEPUTADO ESTADUAL,PRB,27,13,40,0.325,0.675
4146,2018,RS,DEPUTADO ESTADUAL,PSB,26,11,37,0.2972972972972973,0.7027027027027027
4147,2018,RS,DEPUTADO ESTADUAL,PMN,33,15,48,0.3125,0.6875
4148,2018,RS,DEPUTADO ESTADUAL,PV,41,21,62,0.3387096774193548,0.6612903225806451
4149,2018,RS,DEPUTADO ESTADUAL,PR,17,8,25,0.32,0.68
4150,2018,RS,DEPUTADO ESTADUAL,PRP,2,0,2,0.0,1.0
4151,2018,RS,DEPUTADO ESTADUAL,MDB,34,15,49,0.30612244897959184,0.6938775510204082
4152,2018,RS,DEPUTADO ESTADUAL,PTC,4,6,10,0.6,0.4
4153,2018,RS,DEPUTADO ESTADUAL,PTB,28,13,41,0.3170731707317073,0.6829268292682927
4154,2018,RS,DEPUTADO ESTADUAL,NOVO,16,7,23,0.30434782608695654,0.6956521739130435
4155,2018,RS,DEPUTADO ESTADUAL,PSC,17,6,23,0.2608695652173913,0.7391304347826086
4156,2018,RS,DEPUTADO ESTADUAL,PODE,10,5,15,0.3333333333333333,0.6666666666666666
4157,2018,RS,DEPUTADO ESTADUAL,PPS,2,1,3,0.3333333333333333,0.6666666666666666
4158,2018,RS,DEPUTADO ESTADUAL,DC,8,3,11,0.2727272727272727,0.7272727272727273
4159,2018,RS,DEPUTADO ESTADUAL,PSD,14,6,20,0.3,0.7
4160,2018,RS,DEPUTADO ESTADUAL,PPL,4,2,6,0.3333333333333333,0.6666666666666666
4161,2018,RS,DEPUTADO ESTADUAL,PCO,0,1,1,1.0,0.0
4162,2018,RS,DEPUTADO ESTADUAL,PSOL,18,8,26,0.3076923076923077,0.6923076923076923
4163,2018,RS,DEPUTADO ESTADUAL,PATRI,3,1,4,0.25,0.75
4164,2018,RS,DEPUTADO ESTADUAL,PCB,0,1,1,1.0,0.0
4165,2018,RS,DEPUTADO ESTADUAL,PSTU,1,2,3,0.6666666666666666,0.3333333333333333
4166,2018,RS,DEPUTADO ESTADUAL,PHS,2,1,3,0.3333333333333333,0.6666666666666666
4167,2018,RS,DEPUTADO FEDERAL,PRP,5,4,9,0.4444444444444444,0.5555555555555556
4168,2018,RS,DEPUTADO FEDERAL,REDE,4,2,6,0.3333333333333333,0.6666666666666666
4169,2018,RS,DEPUTADO FEDERAL,PC do B,18,8,26,0.3076923076923077,0.6923076923076923
4170,2018,RS,DEPUTADO FEDERAL,PP,14,5,19,0.2631578947368421,0.7368421052631579
4171,2018,RS,DEPUTADO FEDERAL,PSD,12,5,17,0.29411764705882354,0.7058823529411765
4172,2018,RS,DEPUTADO FEDERAL,PSOL,26,14,40,0.35,0.65
4173,2018,RS,DEPUTADO FEDERAL,PTC,4,4,8,0.5,0.5
4174,2018,RS,DEPUTADO FEDERAL,PT,14,6,20,0.3,0.7
4175,2018,RS,DEPUTADO FEDERAL,PSL,14,8,22,0.36363636363636365,0.6363636363636364
4176,2018,RS,DEPUTADO FEDERAL,PSB,20,10,30,0.3333333333333333,0.6666666666666666
4177,2018,RS,DEPUTADO FEDERAL,PSTU,3,2,5,0.4,0.6
4178,2018,RS,DEPUTADO FEDERAL,DEM,8,1,9,0.1111111111111111,0.8888888888888888
4179,2018,RS,DEPUTADO FEDERAL,PTB,6,3,9,0.3333333333333333,0.6666666666666666
4180,2018,RS,DEPUTADO FEDERAL,PSDB,4,3,7,0.42857142857142855,0.5714285714285714
4181,2018,RS,DEPUTADO FEDERAL,PPL,14,8,22,0.36363636363636365,0.6363636363636364
4182,2018,RS,DEPUTADO FEDERAL,MDB,18,8,26,0.3076923076923077,0.6923076923076923
4183,2018,RS,DEPUTADO FEDERAL,PROS,7,5,12,0.4166666666666667,0.5833333333333334
4184,2018,RS,DEPUTADO FEDERAL,PRB,5,2,7,0.2857142857142857,0.7142857142857143
4185,2018,RS,DEPUTADO FEDERAL,PPS,20,10,30,0.3333333333333333,0.6666666666666666
4186,2018,RS,DEPUTADO FEDERAL,AVANTE,3,2,5,0.4,0.6
4187,2018,RS,DEPUTADO FEDERAL,PCO,1,0,1,0.0,1.0
4188,2018,RS,DEPUTADO FEDERAL,PDT,17,6,23,0.2608695652173913,0.7391304347826086
4189,2018,RS,DEPUTADO FEDERAL,NOVO,12,6,18,0.3333333333333333,0.6666666666666666
4190,2018,RS,DEPUTADO FEDERAL,SOLIDARIEDADE,1,1,2,0.5,0.5
4191,2018,RS,DEPUTADO FEDERAL,PR,5,2,7,0.2857142857142857,0.7142857142857143
4192,2018,RS,DEPUTADO FEDERAL,PSC,8,1,9,0.1111111111111111,0.8888888888888888
4193,2018,RS,DEPUTADO FEDERAL,DC,2,1,3,0.3333333333333333,0.6666666666666666
4194,2018,RS,DEPUTADO FEDERAL,PATRI,4,1,5,0.2,0.8
4195,2018,RS,DEPUTADO FEDERAL,PMB,6,6,12,0.5,0.5
4196,2018,RS,DEPUTADO FEDERAL,PHS,4,1,5,0.2,0.8
4197,2018,RS,DEPUTADO FEDERAL,PMN,2,1,3,0.3333333333333333,0.6666666666666666
4198,2018,RS,DEPUTADO FEDERAL,PODE,1,1,2,0.5,0.5
4199,2018,RS,DEPUTADO FEDERAL,PV,1,0,1,0.0,1.0
4200,2018,RS,DEPUTADO FEDERAL,PCB,1,0,1,0.0,1.0
4201,2018,RS,SENADOR,MDB,1,0,1,0.0,1.0
4202,2018,RS,SENADOR,PSTU,1,1,2,0.5,0.5
4203,2018,RS,SENADOR,PP,1,0,1,0.0,1.0
4204,2018,RS,SENADOR,DC,1,0,1,0.0,1.0
4205,2018,RS,SENADOR,PCO,1,0,1,0.0,1.0
4206,2018,RS,SENADOR,PODE,0,1,1,1.0,0.0
4207,2018,RS,SENADOR,PCB,1,0,1,0.0,1.0
4208,2018,RS,SENADOR,PSB,1,0,1,0.0,1.0
4209,2018,RS,SENADOR,SOLIDARIEDADE,0,1,1,1.0,0.0
4210,2018,RS,SENADOR,PT,1,0,1,0.0,1.0
4211,2018,RS,SENADOR,PSOL,1,0,1,0.0,1.0
4212,2018,RS,SENADOR,PPS,1,0,1,0.0,1.0
4213,2018,RS,SENADOR,PSL,0,1,1,1.0,0.0
4214,2018,RS,SENADOR,PC do B,0,1,1,1.0,0.0
4215,2010,RO,DEPUTADO ESTADUAL,PSDC,23,3,26,0.11538461538461539,0.8846153846153846
4216,2010,RO,DEPUTADO ESTADUAL,PSDB,19,3,22,0.13636363636363635,0.8636363636363636
4217,2010,RO,DEPUTADO ESTADUAL,PPS,9,3,12,0.25,0.75
4218,2010,RO,DEPUTADO ESTADUAL,DEM,13,1,14,0.07142857142857142,0.9285714285714286
4219,2010,RO,DEPUTADO ESTADUAL,PRP,19,3,22,0.13636363636363635,0.8636363636363636
4220,2010,RO,DEPUTADO ESTADUAL,PSC,15,5,20,0.25,0.75
4221,2010,RO,DEPUTADO ESTADUAL,PMDB,28,7,35,0.2,0.8
4222,2010,RO,DEPUTADO ESTADUAL,PV,20,6,26,0.23076923076923078,0.7692307692307693
4223,2010,RO,DEPUTADO ESTADUAL,PSOL,6,1,7,0.14285714285714285,0.8571428571428571
4224,2010,RO,DEPUTADO ESTADUAL,PP,13,2,15,0.13333333333333333,0.8666666666666667
4225,2010,RO,DEPUTADO ESTADUAL,PRB,14,5,19,0.2631578947368421,0.7368421052631579
4226,2010,RO,DEPUTADO ESTADUAL,PR,13,3,16,0.1875,0.8125
4227,2010,RO,DEPUTADO ESTADUAL,PT,23,9,32,0.28125,0.71875
4228,2010,RO,DEPUTADO ESTADUAL,PC do B,22,3,25,0.12,0.88
4229,2010,RO,DEPUTADO ESTADUAL,PHS,13,1,14,0.07142857142857142,0.9285714285714286
4230,2010,RO,DEPUTADO ESTADUAL,PMN,8,2,10,0.2,0.8
4231,2010,RO,DEPUTADO ESTADUAL,PT do B,7,1,8,0.125,0.875
4232,2010,RO,DEPUTADO ESTADUAL,PSB,12,0,12,0.0,1.0
4233,2010,RO,DEPUTADO ESTADUAL,PRTB,4,0,4,0.0,1.0
4234,2010,RO,DEPUTADO ESTADUAL,PTN,11,1,12,0.08333333333333333,0.9166666666666666
4235,2010,RO,DEPUTADO ESTADUAL,PDT,12,3,15,0.2,0.8
4236,2010,RO,DEPUTADO ESTADUAL,PTB,7,3,10,0.3,0.7
4237,2010,RO,DEPUTADO ESTADUAL,PSL,6,1,7,0.14285714285714285,0.8571428571428571
4238,2010,RO,DEPUTADO FEDERAL,PC do B,3,1,4,0.25,0.75
4239,2010,RO,DEPUTADO FEDERAL,PSC,4,1,5,0.2,0.8
4240,2010,RO,DEPUTADO FEDERAL,PR,2,2,4,0.5,0.5
4241,2010,RO,DEPUTADO FEDERAL,PMDB,6,4,10,0.4,0.6
4242,2010,RO,DEPUTADO FEDERAL,PT,10,2,12,0.16666666666666666,0.8333333333333334
4243,2010,RO,DEPUTADO FEDERAL,PP,7,1,8,0.125,0.875
4244,2010,RO,DEPUTADO FEDERAL,PTB,2,2,4,0.5,0.5
4245,2010,RO,DEPUTADO FEDERAL,PDT,6,1,7,0.14285714285714285,0.8571428571428571
4246,2010,RO,DEPUTADO FEDERAL,PSDC,2,0,2,0.0,1.0
4247,2010,RO,DEPUTADO FEDERAL,PRB,1,0,1,0.0,1.0
4248,2010,RO,DEPUTADO FEDERAL,PPS,2,0,2,0.0,1.0
4249,2010,RO,DEPUTADO FEDERAL,PSOL,3,1,4,0.25,0.75
4250,2010,RO,DEPUTADO FEDERAL,PSDB,3,2,5,0.4,0.6
4251,2010,RO,DEPUTADO FEDERAL,PRTB,1,1,2,0.5,0.5
4252,2010,RO,DEPUTADO FEDERAL,PTC,1,0,1,0.0,1.0
4253,2010,RO,DEPUTADO FEDERAL,PHS,2,1,3,0.3333333333333333,0.6666666666666666
4254,2010,RO,DEPUTADO FEDERAL,PT do B,2,0,2,0.0,1.0
4255,2010,RO,DEPUTADO FEDERAL,PV,2,0,2,0.0,1.0
4256,2010,RO,DEPUTADO FEDERAL,PSB,1,0,1,0.0,1.0
4257,2010,RO,DEPUTADO FEDERAL,PMN,1,1,2,0.5,0.5
4258,2010,RO,DEPUTADO FEDERAL,DEM,1,0,1,0.0,1.0
4259,2010,RO,SENADOR,PSC,1,0,1,0.0,1.0
4260,2010,RO,SENADOR,PSOL,3,0,3,0.0,1.0
4261,2010,RO,SENADOR,PT,0,1,1,1.0,0.0
4262,2010,RO,SENADOR,PP,1,0,1,0.0,1.0
4263,2010,RO,SENADOR,PHS,1,0,1,0.0,1.0
4264,2010,RO,SENADOR,PMDB,1,0,1,0.0,1.0
4265,2010,RO,SENADOR,PV,1,0,1,0.0,1.0
4266,2014,RO,DEPUTADO ESTADUAL,PMDB,19,8,27,0.2962962962962963,0.7037037037037037
4267,2014,RO,DEPUTADO ESTADUAL,PC do B,18,12,30,0.4,0.6
4268,2014,RO,DEPUTADO ESTADUAL,DEM,9,3,12,0.25,0.75
4269,2014,RO,DEPUTADO ESTADUAL,PTN,7,4,11,0.36363636363636365,0.6363636363636364
4270,2014,RO,DEPUTADO ESTADUAL,PSD,11,7,18,0.3888888888888889,0.6111111111111112
4271,2014,RO,DEPUTADO ESTADUAL,SD,4,1,5,0.2,0.8
4272,2014,RO,DEPUTADO ESTADUAL,PSDC,30,12,42,0.2857142857142857,0.7142857142857143
4273,2014,RO,DEPUTADO ESTADUAL,PSDB,17,9,26,0.34615384615384615,0.6538461538461539
4274,2014,RO,DEPUTADO ESTADUAL,PT do B,24,9,33,0.2727272727272727,0.7272727272727273
4275,2014,RO,DEPUTADO ESTADUAL,PDT,9,6,15,0.4,0.6
4276,2014,RO,DEPUTADO ESTADUAL,PSC,10,4,14,0.2857142857142857,0.7142857142857143
4277,2014,RO,DEPUTADO ESTADUAL,PR,6,4,10,0.4,0.6
4278,2014,RO,DEPUTADO ESTADUAL,PTC,6,3,9,0.3333333333333333,0.6666666666666666
4279,2014,RO,DEPUTADO ESTADUAL,PP,15,5,20,0.25,0.75
4280,2014,RO,DEPUTADO ESTADUAL,PEN,13,11,24,0.4583333333333333,0.5416666666666666
4281,2014,RO,DEPUTADO ESTADUAL,PRB,11,7,18,0.3888888888888889,0.6111111111111112
4282,2014,RO,DEPUTADO ESTADUAL,PSOL,6,2,8,0.25,0.75
4283,2014,RO,DEPUTADO ESTADUAL,PV,15,10,25,0.4,0.6
4284,2014,RO,DEPUTADO ESTADUAL,PT,19,10,29,0.3448275862068966,0.6551724137931034
4285,2014,RO,DEPUTADO ESTADUAL,PHS,4,3,7,0.42857142857142855,0.5714285714285714
4286,2014,RO,DEPUTADO ESTADUAL,PSL,6,0,6,0.0,1.0
4287,2014,RO,DEPUTADO ESTADUAL,PSTU,3,2,5,0.4,0.6
4288,2014,RO,DEPUTADO ESTADUAL,PROS,3,0,3,0.0,1.0
4289,2014,RO,DEPUTADO ESTADUAL,PSB,15,5,20,0.25,0.75
4290,2014,RO,DEPUTADO ESTADUAL,PRP,7,4,11,0.36363636363636365,0.6363636363636364
4291,2014,RO,DEPUTADO ESTADUAL,PMN,7,2,9,0.2222222222222222,0.7777777777777778
4292,2014,RO,DEPUTADO ESTADUAL,PTB,5,2,7,0.2857142857142857,0.7142857142857143
4293,2014,RO,DEPUTADO ESTADUAL,PPS,3,0,3,0.0,1.0
4294,2014,RO,DEPUTADO ESTADUAL,PRTB,1,0,1,0.0,1.0
4295,2014,RO,DEPUTADO FEDERAL,PC do B,1,2,3,0.6666666666666666,0.3333333333333333
4296,2014,RO,DEPUTADO FEDERAL,PHS,1,1,2,0.5,0.5
4297,2014,RO,DEPUTADO FEDERAL,PT,8,5,13,0.38461538461538464,0.6153846153846154
4298,2014,RO,DEPUTADO FEDERAL,PV,6,3,9,0.3333333333333333,0.6666666666666666
4299,2014,RO,DEPUTADO FEDERAL,PSDB,2,4,6,0.6666666666666666,0.3333333333333333
4300,2014,RO,DEPUTADO FEDERAL,PP,7,3,10,0.3,0.7
4301,2014,RO,DEPUTADO FEDERAL,PMN,1,0,1,0.0,1.0
4302,2014,RO,DEPUTADO FEDERAL,PMDB,8,3,11,0.2727272727272727,0.7272727272727273
4303,2014,RO,DEPUTADO FEDERAL,PTB,3,1,4,0.25,0.75
4304,2014,RO,DEPUTADO FEDERAL,PT do B,6,2,8,0.25,0.75
4305,2014,RO,DEPUTADO FEDERAL,PRTB,0,1,1,1.0,0.0
4306,2014,RO,DEPUTADO FEDERAL,PSD,1,0,1,0.0,1.0
4307,2014,RO,DEPUTADO FEDERAL,PSOL,2,2,4,0.5,0.5
4308,2014,RO,DEPUTADO FEDERAL,PROS,1,2,3,0.6666666666666666,0.3333333333333333
4309,2014,RO,DEPUTADO FEDERAL,PTC,1,0,1,0.0,1.0
4310,2014,RO,DEPUTADO FEDERAL,PSDC,1,0,1,0.0,1.0
4311,2014,RO,DEPUTADO FEDERAL,PEN,2,0,2,0.0,1.0
4312,2014,RO,DEPUTADO FEDERAL,PSTU,2,0,2,0.0,1.0
4313,2014,RO,DEPUTADO FEDERAL,DEM,2,0,2,0.0,1.0
4314,2014,RO,DEPUTADO FEDERAL,PDT,3,0,3,0.0,1.0
4315,2014,RO,DEPUTADO FEDERAL,PR,2,0,2,0.0,1.0
4316,2014,RO,DEPUTADO FEDERAL,SD,1,0,1,0.0,1.0
4317,2014,RO,DEPUTADO FEDERAL,PSL,0,1,1,1.0,0.0
4318,2014,RO,DEPUTADO FEDERAL,PRP,0,1,1,1.0,0.0
4319,2014,RO,DEPUTADO FEDERAL,PSC,1,0,1,0.0,1.0
4320,2014,RO,DEPUTADO FEDERAL,PRB,1,0,1,0.0,1.0
4321,2014,RO,DEPUTADO FEDERAL,PSB,1,0,1,0.0,1.0
4322,2014,RO,SENADOR,PSOL,1,0,1,0.0,1.0
4323,2014,RO,SENADOR,PDT,1,0,1,0.0,1.0
4324,2014,RO,SENADOR,PP,0,1,1,1.0,0.0
4325,2014,RO,SENADOR,PSD,1,0,1,0.0,1.0
4326,2018,RO,DEPUTADO ESTADUAL,PRP,2,7,9,0.7777777777777778,0.2222222222222222
4327,2018,RO,DEPUTADO ESTADUAL,PSDB,8,4,12,0.3333333333333333,0.6666666666666666
4328,2018,RO,DEPUTADO ESTADUAL,PSTU,4,3,7,0.42857142857142855,0.5714285714285714
4329,2018,RO,DEPUTADO ESTADUAL,PTC,15,6,21,0.2857142857142857,0.7142857142857143
4330,2018,RO,DEPUTADO ESTADUAL,PODE,20,9,29,0.3103448275862069,0.6896551724137931
4331,2018,RO,DEPUTADO ESTADUAL,PR,9,4,13,0.3076923076923077,0.6923076923076923
4332,2018,RO,DEPUTADO ESTADUAL,DC,12,5,17,0.29411764705882354,0.7058823529411765
4333,2018,RO,DEPUTADO ESTADUAL,PDT,15,4,19,0.21052631578947367,0.7894736842105263
4334,2018,RO,DEPUTADO ESTADUAL,PRB,27,14,41,0.34146341463414637,0.6585365853658537
4335,2018,RO,DEPUTADO ESTADUAL,PMN,11,4,15,0.26666666666666666,0.7333333333333333
4336,2018,RO,DEPUTADO ESTADUAL,PHS,10,5,15,0.3333333333333333,0.6666666666666666
4337,2018,RO,DEPUTADO ESTADUAL,PATRI,7,1,8,0.125,0.875
4338,2018,RO,DEPUTADO ESTADUAL,PV,11,4,15,0.26666666666666666,0.7333333333333333
4339,2018,RO,DEPUTADO ESTADUAL,PC do B,7,4,11,0.36363636363636365,0.6363636363636364
4340,2018,RO,DEPUTADO ESTADUAL,PSB,16,9,25,0.36,0.64
4341,2018,RO,DEPUTADO ESTADUAL,PSL,14,7,21,0.3333333333333333,0.6666666666666666
4342,2018,RO,DEPUTADO ESTADUAL,PSD,9,5,14,0.35714285714285715,0.6428571428571429
4343,2018,RO,DEPUTADO ESTADUAL,PT,18,17,35,0.4857142857142857,0.5142857142857142
4344,2018,RO,DEPUTADO ESTADUAL,MDB,12,6,18,0.3333333333333333,0.6666666666666666
4345,2018,RO,DEPUTADO ESTADUAL,PP,15,6,21,0.2857142857142857,0.7142857142857143
4346,2018,RO,DEPUTADO ESTADUAL,PROS,11,4,15,0.26666666666666666,0.7333333333333333
4347,2018,RO,DEPUTADO ESTADUAL,PTB,6,3,9,0.3333333333333333,0.6666666666666666
4348,2018,RO,DEPUTADO ESTADUAL,DEM,10,3,13,0.23076923076923078,0.7692307692307693
4349,2018,RO,DEPUTADO ESTADUAL,REDE,11,2,13,0.15384615384615385,0.8461538461538461
4350,2018,RO,DEPUTADO ESTADUAL,PSC,10,4,14,0.2857142857142857,0.7142857142857143
4351,2018,RO,DEPUTADO ESTADUAL,SOLIDARIEDADE,2,1,3,0.3333333333333333,0.6666666666666666
4352,2018,RO,DEPUTADO ESTADUAL,PPS,10,2,12,0.16666666666666666,0.8333333333333334
4353,2018,RO,DEPUTADO ESTADUAL,PMB,6,3,9,0.3333333333333333,0.6666666666666666
4354,2018,RO,DEPUTADO ESTADUAL,PSOL,3,1,4,0.25,0.75
4355,2018,RO,DEPUTADO FEDERAL,PV,5,1,6,0.16666666666666666,0.8333333333333334
4356,2018,RO,DEPUTADO FEDERAL,PR,1,1,2,0.5,0.5
4357,2018,RO,DEPUTADO FEDERAL,PHS,4,1,5,0.2,0.8
4358,2018,RO,DEPUTADO FEDERAL,MDB,5,4,9,0.4444444444444444,0.5555555555555556
4359,2018,RO,DEPUTADO FEDERAL,PRB,1,0,1,0.0,1.0
4360,2018,RO,DEPUTADO FEDERAL,PSDB,0,2,2,1.0,0.0
4361,2018,RO,DEPUTADO FEDERAL,PT,5,3,8,0.375,0.625
4362,2018,RO,DEPUTADO FEDERAL,PSL,9,4,13,0.3076923076923077,0.6923076923076923
4363,2018,RO,DEPUTADO FEDERAL,PRP,3,3,6,0.5,0.5
4364,2018,RO,DEPUTADO FEDERAL,PSOL,2,1,3,0.3333333333333333,0.6666666666666666
4365,2018,RO,DEPUTADO FEDERAL,PC do B,1,1,2,0.5,0.5
4366,2018,RO,DEPUTADO FEDERAL,NOVO,2,1,3,0.3333333333333333,0.6666666666666666
4367,2018,RO,DEPUTADO FEDERAL,REDE,5,1,6,0.16666666666666666,0.8333333333333334
4368,2018,RO,DEPUTADO FEDERAL,PTB,1,0,1,0.0,1.0
4369,2018,RO,DEPUTADO FEDERAL,PMN,3,1,4,0.25,0.75
4370,2018,RO,DEPUTADO FEDERAL,PATRI,3,0,3,0.0,1.0
4371,2018,RO,DEPUTADO FEDERAL,PDT,3,1,4,0.25,0.75
4372,2018,RO,DEPUTADO FEDERAL,PSTU,1,1,2,0.5,0.5
4373,2018,RO,DEPUTADO FEDERAL,PROS,2,2,4,0.5,0.5
4374,2018,RO,DEPUTADO FEDERAL,DEM,5,2,7,0.2857142857142857,0.7142857142857143
4375,2018,RO,DEPUTADO FEDERAL,PPS,2,1,3,0.3333333333333333,0.6666666666666666
4376,2018,RO,DEPUTADO FEDERAL,PSD,1,1,2,0.5,0.5
4377,2018,RO,DEPUTADO FEDERAL,PSC,2,0,2,0.0,1.0
4378,2018,RO,DEPUTADO FEDERAL,PMB,5,2,7,0.2857142857142857,0.7142857142857143
4379,2018,RO,DEPUTADO FEDERAL,PODE,1,0,1,0.0,1.0
4380,2018,RO,DEPUTADO FEDERAL,PRTB,1,2,3,0.6666666666666666,0.3333333333333333
4381,2018,RO,DEPUTADO FEDERAL,PP,2,2,4,0.5,0.5
4382,2018,RO,DEPUTADO FEDERAL,PSB,1,0,1,0.0,1.0
4383,2018,RO,DEPUTADO FEDERAL,SOLIDARIEDADE,1,0,1,0.0,1.0
4384,2018,RO,DEPUTADO FEDERAL,DC,0,1,1,1.0,0.0
4385,2018,RO,DEPUTADO FEDERAL,PTC,1,0,1,0.0,1.0
4386,2018,RO,SENADOR,PT,0,1,1,1.0,0.0
4387,2018,RO,SENADOR,DEM,1,0,1,0.0,1.0
4388,2018,RO,SENADOR,PSL,1,0,1,0.0,1.0
4389,2018,RO,SENADOR,PMB,2,0,2,0.0,1.0
4390,2018,RO,SENADOR,MDB,2,0,2,0.0,1.0
4391,2018,RO,SENADOR,PRTB,1,0,1,0.0,1.0
4392,2018,RO,SENADOR,PRB,1,0,1,0.0,1.0
4393,2018,RO,SENADOR,PSTU,2,0,2,0.0,1.0
4394,2018,RO,SENADOR,NOVO,1,0,1,0.0,1.0
4395,2018,RO,SENADOR,REDE,1,0,1,0.0,1.0
4396,2018,RO,SENADOR,PP,1,0,1,0.0,1.0
4397,2018,RO,SENADOR,PPS,1,0,1,0.0,1.0
4398,2018,RO,SENADOR,PSB,1,0,1,0.0,1.0
4399,2010,RR,DEPUTADO ESTADUAL,PRB,18,8,26,0.3076923076923077,0.6923076923076923
4400,2010,RR,DEPUTADO ESTADUAL,PRP,20,18,38,0.47368421052631576,0.5263157894736842
4401,2010,RR,DEPUTADO ESTADUAL,PSL,47,21,68,0.3088235294117647,0.6911764705882353
4402,2010,RR,DEPUTADO ESTADUAL,PP,22,11,33,0.3333333333333333,0.6666666666666666
4403,2010,RR,DEPUTADO ESTADUAL,PV,20,8,28,0.2857142857142857,0.7142857142857143
4404,2010,RR,DEPUTADO ESTADUAL,PPS,16,9,25,0.36,0.64
4405,2010,RR,DEPUTADO ESTADUAL,PTB,9,4,13,0.3076923076923077,0.6923076923076923
4406,2010,RR,DEPUTADO ESTADUAL,PRTB,24,10,34,0.29411764705882354,0.7058823529411765
4407,2010,RR,DEPUTADO ESTADUAL,PC do B,12,5,17,0.29411764705882354,0.7058823529411765
4408,2010,RR,DEPUTADO ESTADUAL,PHS,30,6,36,0.16666666666666666,0.8333333333333334
4409,2010,RR,DEPUTADO ESTADUAL,PSDC,16,6,22,0.2727272727272727,0.7272727272727273
4410,2010,RR,DEPUTADO ESTADUAL,PT,7,5,12,0.4166666666666667,0.5833333333333334
4411,2010,RR,DEPUTADO ESTADUAL,PSC,15,4,19,0.21052631578947367,0.7894736842105263
4412,2010,RR,DEPUTADO ESTADUAL,PDT,16,0,16,0.0,1.0
4413,2010,RR,DEPUTADO ESTADUAL,PR,6,2,8,0.25,0.75
4414,2010,RR,DEPUTADO ESTADUAL,DEM,8,4,12,0.3333333333333333,0.6666666666666666
4415,2010,RR,DEPUTADO ESTADUAL,PMN,3,0,3,0.0,1.0
4416,2010,RR,DEPUTADO ESTADUAL,PSDB,9,5,14,0.35714285714285715,0.6428571428571429
4417,2010,RR,DEPUTADO ESTADUAL,PTN,4,1,5,0.2,0.8
4418,2010,RR,DEPUTADO ESTADUAL,PSB,6,1,7,0.14285714285714285,0.8571428571428571
4419,2010,RR,DEPUTADO ESTADUAL,PMDB,3,1,4,0.25,0.75
4420,2010,RR,DEPUTADO ESTADUAL,PCO,1,0,1,0.0,1.0
4421,2010,RR,DEPUTADO ESTADUAL,PTC,2,1,3,0.3333333333333333,0.6666666666666666
4422,2010,RR,DEPUTADO ESTADUAL,PSOL,1,1,2,0.5,0.5
4423,2010,RR,DEPUTADO FEDERAL,PSL,4,1,5,0.2,0.8
4424,2010,RR,DEPUTADO FEDERAL,PP,7,1,8,0.125,0.875
4425,2010,RR,DEPUTADO FEDERAL,PRB,3,0,3,0.0,1.0
4426,2010,RR,DEPUTADO FEDERAL,PV,3,1,4,0.25,0.75
4427,2010,RR,DEPUTADO FEDERAL,PR,2,2,4,0.5,0.5
4428,2010,RR,DEPUTADO FEDERAL,PT,1,2,3,0.6666666666666666,0.3333333333333333
4429,2010,RR,DEPUTADO FEDERAL,PTB,5,1,6,0.16666666666666666,0.8333333333333334
4430,2010,RR,DEPUTADO FEDERAL,PRTB,3,1,4,0.25,0.75
4431,2010,RR,DEPUTADO FEDERAL,PSOL,1,1,2,0.5,0.5
4432,2010,RR,DEPUTADO FEDERAL,PSC,3,2,5,0.4,0.6
4433,2010,RR,DEPUTADO FEDERAL,PMDB,3,1,4,0.25,0.75
4434,2010,RR,DEPUTADO FEDERAL,DEM,4,1,5,0.2,0.8
4435,2010,RR,DEPUTADO FEDERAL,PCO,0,1,1,1.0,0.0
4436,2010,RR,DEPUTADO FEDERAL,PSDB,3,1,4,0.25,0.75
4437,2010,RR,DEPUTADO FEDERAL,PHS,7,0,7,0.0,1.0
4438,2010,RR,DEPUTADO FEDERAL,PRP,1,2,3,0.6666666666666666,0.3333333333333333
4439,2010,RR,DEPUTADO FEDERAL,PC do B,0,1,1,1.0,0.0
4440,2010,RR,DEPUTADO FEDERAL,PDT,2,0,2,0.0,1.0
4441,2010,RR,DEPUTADO FEDERAL,PSB,0,1,1,1.0,0.0
4442,2010,RR,DEPUTADO FEDERAL,PTN,0,1,1,1.0,0.0
4443,2010,RR,DEPUTADO FEDERAL,PMN,1,0,1,0.0,1.0
4444,2010,RR,SENADOR,PT,0,1,1,1.0,0.0
4445,2010,RR,SENADOR,PHS,2,0,2,0.0,1.0
4446,2010,RR,SENADOR,PSOL,1,0,1,0.0,1.0
4447,2010,RR,SENADOR,PCO,1,0,1,0.0,1.0
4448,2010,RR,SENADOR,PV,1,0,1,0.0,1.0
4449,2010,RR,SENADOR,PSDB,0,1,1,1.0,0.0
4450,2010,RR,SENADOR,PMDB,1,0,1,0.0,1.0
4451,2010,RR,SENADOR,PDT,1,0,1,0.0,1.0
4452,2014,RR,DEPUTADO ESTADUAL,PROS,8,8,16,0.5,0.5
4453,2014,RR,DEPUTADO ESTADUAL,PTN,6,1,7,0.14285714285714285,0.8571428571428571
4454,2014,RR,DEPUTADO ESTADUAL,PPL,14,6,20,0.3,0.7
4455,2014,RR,DEPUTADO ESTADUAL,PT do B,17,8,25,0.32,0.68
4456,2014,RR,DEPUTADO ESTADUAL,PC do B,22,12,34,0.35294117647058826,0.6470588235294118
4457,2014,RR,DEPUTADO ESTADUAL,PSDC,14,5,19,0.2631578947368421,0.7368421052631579
4458,2014,RR,DEPUTADO ESTADUAL,PRP,34,15,49,0.30612244897959184,0.6938775510204082
4459,2014,RR,DEPUTADO ESTADUAL,PRTB,21,11,32,0.34375,0.65625
4460,2014,RR,DEPUTADO ESTADUAL,DEM,2,2,4,0.5,0.5
4461,2014,RR,DEPUTADO ESTADUAL,PTB,2,2,4,0.5,0.5
4462,2014,RR,DEPUTADO ESTADUAL,PSOL,5,3,8,0.375,0.625
4463,2014,RR,DEPUTADO ESTADUAL,PPS,22,9,31,0.2903225806451613,0.7096774193548387
4464,2014,RR,DEPUTADO ESTADUAL,PRB,14,7,21,0.3333333333333333,0.6666666666666666
4465,2014,RR,DEPUTADO ESTADUAL,SD,9,2,11,0.18181818181818182,0.8181818181818182
4466,2014,RR,DEPUTADO ESTADUAL,PDT,14,3,17,0.17647058823529413,0.8235294117647058
4467,2014,RR,DEPUTADO ESTADUAL,PT,5,3,8,0.375,0.625
4468,2014,RR,DEPUTADO ESTADUAL,PR,5,2,7,0.2857142857142857,0.7142857142857143
4469,2014,RR,DEPUTADO ESTADUAL,PP,10,4,14,0.2857142857142857,0.7142857142857143
4470,2014,RR,DEPUTADO ESTADUAL,PV,8,8,16,0.5,0.5
4471,2014,RR,DEPUTADO ESTADUAL,PSC,9,3,12,0.25,0.75
4472,2014,RR,DEPUTADO ESTADUAL,PSB,11,2,13,0.15384615384615385,0.8461538461538461
4473,2014,RR,DEPUTADO ESTADUAL,PEN,7,1,8,0.125,0.875
4474,2014,RR,DEPUTADO ESTADUAL,PHS,9,2,11,0.18181818181818182,0.8181818181818182
4475,2014,RR,DEPUTADO ESTADUAL,PSD,1,1,2,0.5,0.5
4476,2014,RR,DEPUTADO ESTADUAL,PTC,2,1,3,0.3333333333333333,0.6666666666666666
4477,2014,RR,DEPUTADO ESTADUAL,PSDB,4,4,8,0.5,0.5
4478,2014,RR,DEPUTADO ESTADUAL,PSL,6,2,8,0.25,0.75
4479,2014,RR,DEPUTADO ESTADUAL,PMDB,4,2,6,0.3333333333333333,0.6666666666666666
4480,2014,RR,DEPUTADO ESTADUAL,PMN,3,5,8,0.625,0.375
4481,2014,RR,DEPUTADO ESTADUAL,PSTU,1,0,1,0.0,1.0
4482,2014,RR,DEPUTADO FEDERAL,PT do B,1,1,2,0.5,0.5
4483,2014,RR,DEPUTADO FEDERAL,PP,3,3,6,0.5,0.5
4484,2014,RR,DEPUTADO FEDERAL,PDT,6,1,7,0.14285714285714285,0.8571428571428571
4485,2014,RR,DEPUTADO FEDERAL,PROS,3,0,3,0.0,1.0
4486,2014,RR,DEPUTADO FEDERAL,PRB,3,0,3,0.0,1.0
4487,2014,RR,DEPUTADO FEDERAL,PRP,3,2,5,0.4,0.6
4488,2014,RR,DEPUTADO FEDERAL,PTN,0,1,1,1.0,0.0
4489,2014,RR,DEPUTADO FEDERAL,PSTU,1,0,1,0.0,1.0
4490,2014,RR,DEPUTADO FEDERAL,PV,5,3,8,0.375,0.625
4491,2014,RR,DEPUTADO FEDERAL,PT,3,2,5,0.4,0.6
4492,2014,RR,DEPUTADO FEDERAL,PMN,2,2,4,0.5,0.5
4493,2014,RR,DEPUTADO FEDERAL,PSDC,2,0,2,0.0,1.0
4494,2014,RR,DEPUTADO FEDERAL,PR,2,1,3,0.3333333333333333,0.6666666666666666
4495,2014,RR,DEPUTADO FEDERAL,PPS,3,2,5,0.4,0.6
4496,2014,RR,DEPUTADO FEDERAL,PEN,1,0,1,0.0,1.0
4497,2014,RR,DEPUTADO FEDERAL,PSOL,0,1,1,1.0,0.0
4498,2014,RR,DEPUTADO FEDERAL,PMDB,1,1,2,0.5,0.5
4499,2014,RR,DEPUTADO FEDERAL,PSC,3,2,5,0.4,0.6
4500,2014,RR,DEPUTADO FEDERAL,PSB,2,1,3,0.3333333333333333,0.6666666666666666
4501,2014,RR,DEPUTADO FEDERAL,PTC,1,0,1,0.0,1.0
4502,2014,RR,DEPUTADO FEDERAL,SD,0,1,1,1.0,0.0
4503,2014,RR,DEPUTADO FEDERAL,PHS,1,0,1,0.0,1.0
4504,2014,RR,DEPUTADO FEDERAL,PC do B,2,2,4,0.5,0.5
4505,2014,RR,DEPUTADO FEDERAL,PSD,1,0,1,0.0,1.0
4506,2014,RR,DEPUTADO FEDERAL,DEM,1,0,1,0.0,1.0
4507,2014,RR,DEPUTADO FEDERAL,PTB,1,0,1,0.0,1.0
4508,2014,RR,DEPUTADO FEDERAL,PSDB,2,1,3,0.3333333333333333,0.6666666666666666
4509,2014,RR,DEPUTADO FEDERAL,PRTB,2,1,3,0.3333333333333333,0.6666666666666666
4510,2014,RR,DEPUTADO FEDERAL,PPL,2,0,2,0.0,1.0
4511,2014,RR,SENADOR,PSDB,1,0,1,0.0,1.0
4512,2014,RR,SENADOR,PDT,1,0,1,0.0,1.0
4513,2014,RR,SENADOR,PR,1,0,1,0.0,1.0
4514,2014,RR,SENADOR,PSTU,1,0,1,0.0,1.0
4515,2014,RR,SENADOR,PPL,0,1,1,1.0,0.0
4516,2014,RR,SENADOR,PTB,1,0,1,0.0,1.0
4517,2018,RR,DEPUTADO ESTADUAL,PTC,23,11,34,0.3235294117647059,0.6764705882352942
4518,2018,RR,DEPUTADO ESTADUAL,PMB,26,12,38,0.3157894736842105,0.6842105263157895
4519,2018,RR,DEPUTADO ESTADUAL,PODE,21,9,30,0.3,0.7
4520,2018,RR,DEPUTADO ESTADUAL,PRB,16,10,26,0.38461538461538464,0.6153846153846154
4521,2018,RR,DEPUTADO ESTADUAL,PRP,7,6,13,0.46153846153846156,0.5384615384615384
4522,2018,RR,DEPUTADO ESTADUAL,MDB,5,4,9,0.4444444444444444,0.5555555555555556
4523,2018,RR,DEPUTADO ESTADUAL,PR,16,5,21,0.23809523809523808,0.7619047619047619
4524,2018,RR,DEPUTADO ESTADUAL,PV,25,12,37,0.32432432432432434,0.6756756756756757
4525,2018,RR,DEPUTADO ESTADUAL,AVANTE,10,5,15,0.3333333333333333,0.6666666666666666
4526,2018,RR,DEPUTADO ESTADUAL,PT,4,2,6,0.3333333333333333,0.6666666666666666
4527,2018,RR,DEPUTADO ESTADUAL,PATRI,15,9,24,0.375,0.625
4528,2018,RR,DEPUTADO ESTADUAL,SOLIDARIEDADE,9,5,14,0.35714285714285715,0.6428571428571429
4529,2018,RR,DEPUTADO ESTADUAL,PTB,21,9,30,0.3,0.7
4530,2018,RR,DEPUTADO ESTADUAL,PRTB,12,10,22,0.45454545454545453,0.5454545454545454
4531,2018,RR,DEPUTADO ESTADUAL,DC,3,2,5,0.4,0.6
4532,2018,RR,DEPUTADO ESTADUAL,PSOL,6,3,9,0.3333333333333333,0.6666666666666666
4533,2018,RR,DEPUTADO ESTADUAL,PSL,13,4,17,0.23529411764705882,0.7647058823529411
4534,2018,RR,DEPUTADO ESTADUAL,PPL,17,4,21,0.19047619047619047,0.8095238095238095
4535,2018,RR,DEPUTADO ESTADUAL,PP,4,3,7,0.42857142857142855,0.5714285714285714
4536,2018,RR,DEPUTADO ESTADUAL,REDE,9,4,13,0.3076923076923077,0.6923076923076923
4537,2018,RR,DEPUTADO ESTADUAL,PSD,10,6,16,0.375,0.625
4538,2018,RR,DEPUTADO ESTADUAL,PSDB,11,2,13,0.15384615384615385,0.8461538461538461
4539,2018,RR,DEPUTADO ESTADUAL,PCB,4,2,6,0.3333333333333333,0.6666666666666666
4540,2018,RR,DEPUTADO ESTADUAL,PC do B,7,1,8,0.125,0.875
4541,2018,RR,DEPUTADO ESTADUAL,PHS,4,2,6,0.3333333333333333,0.6666666666666666
4542,2018,RR,DEPUTADO ESTADUAL,DEM,5,3,8,0.375,0.625
4543,2018,RR,DEPUTADO ESTADUAL,PPS,5,5,10,0.5,0.5
4544,2018,RR,DEPUTADO ESTADUAL,PSC,8,1,9,0.1111111111111111,0.8888888888888888
4545,2018,RR,DEPUTADO ESTADUAL,PDT,3,2,5,0.4,0.6
4546,2018,RR,DEPUTADO ESTADUAL,PROS,2,3,5,0.6,0.4
4547,2018,RR,DEPUTADO ESTADUAL,PSB,4,1,5,0.2,0.8
4548,2018,RR,DEPUTADO FEDERAL,PDT,2,2,4,0.5,0.5
4549,2018,RR,DEPUTADO FEDERAL,PMB,2,0,2,0.0,1.0
4550,2018,RR,DEPUTADO FEDERAL,PHS,3,7,10,0.7,0.3
4551,2018,RR,DEPUTADO FEDERAL,AVANTE,6,2,8,0.25,0.75
4552,2018,RR,DEPUTADO FEDERAL,MDB,2,1,3,0.3333333333333333,0.6666666666666666
4553,2018,RR,DEPUTADO FEDERAL,PROS,5,2,7,0.2857142857142857,0.7142857142857143
4554,2018,RR,DEPUTADO FEDERAL,PSD,2,2,4,0.5,0.5
4555,2018,RR,DEPUTADO FEDERAL,PSB,4,1,5,0.2,0.8
4556,2018,RR,DEPUTADO FEDERAL,PTC,2,0,2,0.0,1.0
4557,2018,RR,DEPUTADO FEDERAL,PR,6,3,9,0.3333333333333333,0.6666666666666666
4558,2018,RR,DEPUTADO FEDERAL,PC do B,3,1,4,0.25,0.75
4559,2018,RR,DEPUTADO FEDERAL,PATRI,6,5,11,0.45454545454545453,0.5454545454545454
4560,2018,RR,DEPUTADO FEDERAL,DC,1,2,3,0.6666666666666666,0.3333333333333333
4561,2018,RR,DEPUTADO FEDERAL,PSDB,2,3,5,0.6,0.4
4562,2018,RR,DEPUTADO FEDERAL,PPS,2,2,4,0.5,0.5
4563,2018,RR,DEPUTADO FEDERAL,PRB,2,1,3,0.3333333333333333,0.6666666666666666
4564,2018,RR,DEPUTADO FEDERAL,DEM,4,1,5,0.2,0.8
4565,2018,RR,DEPUTADO FEDERAL,PSL,6,3,9,0.3333333333333333,0.6666666666666666
4566,2018,RR,DEPUTADO FEDERAL,PRP,2,2,4,0.5,0.5
4567,2018,RR,DEPUTADO FEDERAL,REDE,3,1,4,0.25,0.75
4568,2018,RR,DEPUTADO FEDERAL,PRTB,3,1,4,0.25,0.75
4569,2018,RR,DEPUTADO FEDERAL,PV,5,1,6,0.16666666666666666,0.8333333333333334
4570,2018,RR,DEPUTADO FEDERAL,PSOL,3,1,4,0.25,0.75
4571,2018,RR,DEPUTADO FEDERAL,SOLIDARIEDADE,6,0,6,0.0,1.0
4572,2018,RR,DEPUTADO FEDERAL,PTB,2,2,4,0.5,0.5
4573,2018,RR,DEPUTADO FEDERAL,PSC,0,2,2,1.0,0.0
4574,2018,RR,DEPUTADO FEDERAL,PODE,13,1,14,0.07142857142857142,0.9285714285714286
4575,2018,RR,DEPUTADO FEDERAL,PT,1,1,2,0.5,0.5
4576,2018,RR,DEPUTADO FEDERAL,PP,3,0,3,0.0,1.0
4577,2018,RR,DEPUTADO FEDERAL,PCB,1,0,1,0.0,1.0
4578,2018,RR,DEPUTADO FEDERAL,PPL,1,0,1,0.0,1.0
4579,2018,RR,DEPUTADO FEDERAL,PSTU,0,1,1,1.0,0.0
4580,2018,RR,SENADOR,PR,1,0,1,0.0,1.0
4581,2018,RR,SENADOR,PSTU,1,0,1,0.0,1.0
4582,2018,RR,SENADOR,PCB,0,1,1,1.0,0.0
4583,2018,RR,SENADOR,PTB,1,0,1,0.0,1.0
4584,2018,RR,SENADOR,MDB,1,0,1,0.0,1.0
4585,2018,RR,SENADOR,PSL,1,0,1,0.0,1.0
4586,2018,RR,SENADOR,PV,1,0,1,0.0,1.0
4587,2018,RR,SENADOR,PRB,1,0,1,0.0,1.0
4588,2018,RR,SENADOR,PATRI,1,0,1,0.0,1.0
4589,2018,RR,SENADOR,DEM,1,0,1,0.0,1.0
4590,2018,RR,SENADOR,PDT,0,1,1,1.0,0.0
4591,2010,SC,DEPUTADO ESTADUAL,PMDB,29,18,47,0.3829787234042553,0.6170212765957447
4592,2010,SC,DEPUTADO ESTADUAL,PT,35,11,46,0.2391304347826087,0.7608695652173914
4593,2010,SC,DEPUTADO ESTADUAL,PDT,22,10,32,0.3125,0.6875
4594,2010,SC,DEPUTADO ESTADUAL,PSB,19,7,26,0.2692307692307692,0.7307692307692307
4595,2010,SC,DEPUTADO ESTADUAL,PSDB,23,9,32,0.28125,0.71875
4596,2010,SC,DEPUTADO ESTADUAL,PTC,6,2,8,0.25,0.75
4597,2010,SC,DEPUTADO ESTADUAL,PPS,19,9,28,0.32142857142857145,0.6785714285714286
4598,2010,SC,DEPUTADO ESTADUAL,PSOL,8,1,9,0.1111111111111111,0.8888888888888888
4599,2010,SC,DEPUTADO ESTADUAL,PRB,3,1,4,0.25,0.75
4600,2010,SC,DEPUTADO ESTADUAL,PV,21,8,29,0.27586206896551724,0.7241379310344828
4601,2010,SC,DEPUTADO ESTADUAL,PP,25,11,36,0.3055555555555556,0.6944444444444444
4602,2010,SC,DEPUTADO ESTADUAL,PHS,1,1,2,0.5,0.5
4603,2010,SC,DEPUTADO ESTADUAL,PC do B,1,1,2,0.5,0.5
4604,2010,SC,DEPUTADO ESTADUAL,PRP,4,2,6,0.3333333333333333,0.6666666666666666
4605,2010,SC,DEPUTADO ESTADUAL,PSC,5,2,7,0.2857142857142857,0.7142857142857143
4606,2010,SC,DEPUTADO ESTADUAL,DEM,19,5,24,0.20833333333333334,0.7916666666666666
4607,2010,SC,DEPUTADO ESTADUAL,PSDC,1,1,2,0.5,0.5
4608,2010,SC,DEPUTADO ESTADUAL,PR,8,2,10,0.2,0.8
4609,2010,SC,DEPUTADO ESTADUAL,PSL,3,1,4,0.25,0.75
4610,2010,SC,DEPUTADO ESTADUAL,PTB,2,1,3,0.3333333333333333,0.6666666666666666
4611,2010,SC,DEPUTADO ESTADUAL,PT do B,2,1,3,0.3333333333333333,0.6666666666666666
4612,2010,SC,DEPUTADO ESTADUAL,PSTU,2,1,3,0.3333333333333333,0.6666666666666666
4613,2010,SC,DEPUTADO ESTADUAL,PRTB,1,1,2,0.5,0.5
4614,2010,SC,DEPUTADO FEDERAL,PP,11,5,16,0.3125,0.6875
4615,2010,SC,DEPUTADO FEDERAL,PT,13,7,20,0.35,0.65
4616,2010,SC,DEPUTADO FEDERAL,PTB,14,7,21,0.3333333333333333,0.6666666666666666
4617,2010,SC,DEPUTADO FEDERAL,PMDB,12,5,17,0.29411764705882354,0.7058823529411765
4618,2010,SC,DEPUTADO FEDERAL,PMN,1,1,2,0.5,0.5
4619,2010,SC,DEPUTADO FEDERAL,PV,14,7,21,0.3333333333333333,0.6666666666666666
4620,2010,SC,DEPUTADO FEDERAL,PDT,10,5,15,0.3333333333333333,0.6666666666666666
4621,2010,SC,DEPUTADO FEDERAL,PRP,1,1,2,0.5,0.5
4622,2010,SC,DEPUTADO FEDERAL,PRTB,3,0,3,0.0,1.0
4623,2010,SC,DEPUTADO FEDERAL,PPS,2,1,3,0.3333333333333333,0.6666666666666666
4624,2010,SC,DEPUTADO FEDERAL,PTC,3,3,6,0.5,0.5
4625,2010,SC,DEPUTADO FEDERAL,PHS,2,1,3,0.3333333333333333,0.6666666666666666
4626,2010,SC,DEPUTADO FEDERAL,PSC,2,0,2,0.0,1.0
4627,2010,SC,DEPUTADO FEDERAL,PSDB,5,3,8,0.375,0.625
4628,2010,SC,DEPUTADO FEDERAL,PSOL,6,0,6,0.0,1.0
4629,2010,SC,DEPUTADO FEDERAL,PC do B,5,3,8,0.375,0.625
4630,2010,SC,DEPUTADO FEDERAL,PSTU,2,1,3,0.3333333333333333,0.6666666666666666
4631,2010,SC,DEPUTADO FEDERAL,DEM,7,2,9,0.2222222222222222,0.7777777777777778
4632,2010,SC,DEPUTADO FEDERAL,PRB,1,0,1,0.0,1.0
4633,2010,SC,DEPUTADO FEDERAL,PR,1,0,1,0.0,1.0
4634,2010,SC,DEPUTADO FEDERAL,PSL,1,0,1,0.0,1.0
4635,2010,SC,DEPUTADO FEDERAL,PSB,1,0,1,0.0,1.0
4636,2010,SC,DEPUTADO FEDERAL,PCB,1,0,1,0.0,1.0
4637,2010,SC,SENADOR,PSTU,1,1,2,0.5,0.5
4638,2010,SC,SENADOR,PT,1,0,1,0.0,1.0
4639,2010,SC,SENADOR,PV,1,0,1,0.0,1.0
4640,2010,SC,SENADOR,PP,1,1,2,0.5,0.5
4641,2010,SC,SENADOR,PC do B,1,0,1,0.0,1.0
4642,2010,SC,SENADOR,PMDB,1,0,1,0.0,1.0
4643,2010,SC,SENADOR,PSOL,1,0,1,0.0,1.0
4644,2010,SC,SENADOR,PSDB,1,0,1,0.0,1.0
4645,2010,SC,SENADOR,PSC,1,0,1,0.0,1.0
4646,2010,SC,SENADOR,PPS,1,0,1,0.0,1.0
4647,2014,SC,DEPUTADO ESTADUAL,PMDB,24,13,37,0.35135135135135137,0.6486486486486487
4648,2014,SC,DEPUTADO ESTADUAL,PT,23,13,36,0.3611111111111111,0.6388888888888888
4649,2014,SC,DEPUTADO ESTADUAL,PEN,14,2,16,0.125,0.875
4650,2014,SC,DEPUTADO ESTADUAL,PR,22,10,32,0.3125,0.6875
4651,2014,SC,DEPUTADO ESTADUAL,PP,31,13,44,0.29545454545454547,0.7045454545454546
4652,2014,SC,DEPUTADO ESTADUAL,PSDB,23,16,39,0.41025641025641024,0.5897435897435898
4653,2014,SC,DEPUTADO ESTADUAL,PSC,40,19,59,0.3220338983050847,0.6779661016949152
4654,2014,SC,DEPUTADO ESTADUAL,PSB,22,3,25,0.12,0.88
4655,2014,SC,DEPUTADO ESTADUAL,PSOL,14,8,22,0.36363636363636365,0.6363636363636364
4656,2014,SC,DEPUTADO ESTADUAL,PRTB,2,7,9,0.7777777777777778,0.2222222222222222
4657,2014,SC,DEPUTADO ESTADUAL,PSDC,2,1,3,0.3333333333333333,0.6666666666666666
4658,2014,SC,DEPUTADO ESTADUAL,PC do B,7,4,11,0.36363636363636365,0.6363636363636364
4659,2014,SC,DEPUTADO ESTADUAL,PTC,3,4,7,0.5714285714285714,0.42857142857142855
4660,2014,SC,DEPUTADO ESTADUAL,PDT,16,6,22,0.2727272727272727,0.7272727272727273
4661,2014,SC,DEPUTADO ESTADUAL,PV,10,6,16,0.375,0.625
4662,2014,SC,DEPUTADO ESTADUAL,PT do B,6,3,9,0.3333333333333333,0.6666666666666666
4663,2014,SC,DEPUTADO ESTADUAL,PPS,8,5,13,0.38461538461538464,0.6153846153846154
4664,2014,SC,DEPUTADO ESTADUAL,DEM,4,2,6,0.3333333333333333,0.6666666666666666
4665,2014,SC,DEPUTADO ESTADUAL,PRP,16,9,25,0.36,0.64
4666,2014,SC,DEPUTADO ESTADUAL,PHS,7,0,7,0.0,1.0
4667,2014,SC,DEPUTADO ESTADUAL,PSD,11,5,16,0.3125,0.6875
4668,2014,SC,DEPUTADO ESTADUAL,PTB,6,3,9,0.3333333333333333,0.6666666666666666
4669,2014,SC,DEPUTADO ESTADUAL,PSTU,2,2,4,0.5,0.5
4670,2014,SC,DEPUTADO ESTADUAL,PSL,2,1,3,0.3333333333333333,0.6666666666666666
4671,2014,SC,DEPUTADO ESTADUAL,PRB,4,0,4,0.0,1.0
4672,2014,SC,DEPUTADO ESTADUAL,PTN,2,2,4,0.5,0.5
4673,2014,SC,DEPUTADO ESTADUAL,SD,2,0,2,0.0,1.0
4674,2014,SC,DEPUTADO ESTADUAL,PPL,6,2,8,0.25,0.75
4675,2014,SC,DEPUTADO ESTADUAL,PROS,2,0,2,0.0,1.0
4676,2014,SC,DEPUTADO ESTADUAL,PMN,1,0,1,0.0,1.0
4677,2014,SC,DEPUTADO FEDERAL,PSD,5,3,8,0.375,0.625
4678,2014,SC,DEPUTADO FEDERAL,PSTU,1,1,2,0.5,0.5
4679,2014,SC,DEPUTADO FEDERAL,PT,12,6,18,0.3333333333333333,0.6666666666666666
4680,2014,SC,DEPUTADO FEDERAL,PMN,4,2,6,0.3333333333333333,0.6666666666666666
4681,2014,SC,DEPUTADO FEDERAL,PTN,2,0,2,0.0,1.0
4682,2014,SC,DEPUTADO FEDERAL,PT do B,4,3,7,0.42857142857142855,0.5714285714285714
4683,2014,SC,DEPUTADO FEDERAL,PSDB,11,5,16,0.3125,0.6875
4684,2014,SC,DEPUTADO FEDERAL,PSB,6,4,10,0.4,0.6
4685,2014,SC,DEPUTADO FEDERAL,PPS,1,1,2,0.5,0.5
4686,2014,SC,DEPUTADO FEDERAL,PSOL,5,3,8,0.375,0.625
4687,2014,SC,DEPUTADO FEDERAL,PRP,10,6,16,0.375,0.625
4688,2014,SC,DEPUTADO FEDERAL,PDT,2,0,2,0.0,1.0
4689,2014,SC,DEPUTADO FEDERAL,PSC,2,1,3,0.3333333333333333,0.6666666666666666
4690,2014,SC,DEPUTADO FEDERAL,PCB,0,1,1,1.0,0.0
4691,2014,SC,DEPUTADO FEDERAL,PP,9,2,11,0.18181818181818182,0.8181818181818182
4692,2014,SC,DEPUTADO FEDERAL,SD,2,0,2,0.0,1.0
4693,2014,SC,DEPUTADO FEDERAL,DEM,2,1,3,0.3333333333333333,0.6666666666666666
4694,2014,SC,DEPUTADO FEDERAL,PTB,1,2,3,0.6666666666666666,0.3333333333333333
4695,2014,SC,DEPUTADO FEDERAL,PV,1,0,1,0.0,1.0
4696,2014,SC,DEPUTADO FEDERAL,PRB,2,1,3,0.3333333333333333,0.6666666666666666
4697,2014,SC,DEPUTADO FEDERAL,PMDB,9,4,13,0.3076923076923077,0.6923076923076923
4698,2014,SC,DEPUTADO FEDERAL,PC do B,0,1,1,1.0,0.0
4699,2014,SC,DEPUTADO FEDERAL,PHS,1,0,1,0.0,1.0
4700,2014,SC,DEPUTADO FEDERAL,PPL,1,0,1,0.0,1.0
4701,2014,SC,DEPUTADO FEDERAL,PRTB,0,1,1,1.0,0.0
4702,2014,SC,DEPUTADO FEDERAL,PSDC,1,0,1,0.0,1.0
4703,2014,SC,DEPUTADO FEDERAL,PEN,1,0,1,0.0,1.0
4704,2014,SC,DEPUTADO FEDERAL,PTC,0,1,1,1.0,0.0
4705,2014,SC,DEPUTADO FEDERAL,PR,1,0,1,0.0,1.0
4706,2014,SC,SENADOR,PMDB,1,0,1,0.0,1.0
4707,2014,SC,SENADOR,PT,1,0,1,0.0,1.0
4708,2014,SC,SENADOR,PSB,1,0,1,0.0,1.0
4709,2014,SC,SENADOR,PSOL,1,0,1,0.0,1.0
4710,2014,SC,SENADOR,PRP,0,1,1,1.0,0.0
4711,2014,SC,SENADOR,PSTU,0,1,1,1.0,0.0
4712,2014,SC,SENADOR,PMN,1,0,1,0.0,1.0
4713,2018,SC,DEPUTADO ESTADUAL,PSDB,18,9,27,0.3333333333333333,0.6666666666666666
4714,2018,SC,DEPUTADO ESTADUAL,REDE,12,6,18,0.3333333333333333,0.6666666666666666
4715,2018,SC,DEPUTADO ESTADUAL,PSL,29,12,41,0.2926829268292683,0.7073170731707317
4716,2018,SC,DEPUTADO ESTADUAL,PATRI,21,10,31,0.3225806451612903,0.6774193548387096
4717,2018,SC,DEPUTADO ESTADUAL,PSB,20,5,25,0.2,0.8
4718,2018,SC,DEPUTADO ESTADUAL,PP,19,5,24,0.20833333333333334,0.7916666666666666
4719,2018,SC,DEPUTADO ESTADUAL,MDB,24,10,34,0.29411764705882354,0.7058823529411765
4720,2018,SC,DEPUTADO ESTADUAL,PTB,4,2,6,0.3333333333333333,0.6666666666666666
4721,2018,SC,DEPUTADO ESTADUAL,PDT,9,4,13,0.3076923076923077,0.6923076923076923
4722,2018,SC,DEPUTADO ESTADUAL,PR,14,4,18,0.2222222222222222,0.7777777777777778
4723,2018,SC,DEPUTADO ESTADUAL,PSD,17,7,24,0.2916666666666667,0.7083333333333334
4724,2018,SC,DEPUTADO ESTADUAL,PRP,15,6,21,0.2857142857142857,0.7142857142857143
4725,2018,SC,DEPUTADO ESTADUAL,PV,4,4,8,0.5,0.5
4726,2018,SC,DEPUTADO ESTADUAL,PRTB,1,1,2,0.5,0.5
4727,2018,SC,DEPUTADO ESTADUAL,SOLIDARIEDADE,10,7,17,0.4117647058823529,0.5882352941176471
4728,2018,SC,DEPUTADO ESTADUAL,DEM,15,7,22,0.3181818181818182,0.6818181818181818
4729,2018,SC,DEPUTADO ESTADUAL,PT,21,9,30,0.3,0.7
4730,2018,SC,DEPUTADO ESTADUAL,PMN,10,4,14,0.2857142857142857,0.7142857142857143
4731,2018,SC,DEPUTADO ESTADUAL,PTC,2,4,6,0.6666666666666666,0.3333333333333333
4732,2018,SC,DEPUTADO ESTADUAL,PRB,5,7,12,0.5833333333333334,0.4166666666666667
4733,2018,SC,DEPUTADO ESTADUAL,PPL,1,0,1,0.0,1.0
4734,2018,SC,DEPUTADO ESTADUAL,PPS,9,1,10,0.1,0.9
4735,2018,SC,DEPUTADO ESTADUAL,PODE,9,4,13,0.3076923076923077,0.6923076923076923
4736,2018,SC,DEPUTADO ESTADUAL,PSOL,11,8,19,0.42105263157894735,0.5789473684210527
4737,2018,SC,DEPUTADO ESTADUAL,AVANTE,1,1,2,0.5,0.5
4738,2018,SC,DEPUTADO ESTADUAL,PSC,2,3,5,0.6,0.4
4739,2018,SC,DEPUTADO ESTADUAL,PC do B,6,4,10,0.4,0.6
4740,2018,SC,DEPUTADO ESTADUAL,DC,3,2,5,0.4,0.6
4741,2018,SC,DEPUTADO ESTADUAL,PCO,1,0,1,0.0,1.0
4742,2018,SC,DEPUTADO ESTADUAL,PHS,1,0,1,0.0,1.0
4743,2018,SC,DEPUTADO ESTADUAL,PSTU,1,1,2,0.5,0.5
4744,2018,SC,DEPUTADO ESTADUAL,PROS,1,0,1,0.0,1.0
4745,2018,SC,DEPUTADO ESTADUAL,PCB,1,0,1,0.0,1.0
4746,2018,SC,DEPUTADO FEDERAL,PRB,2,3,5,0.6,0.4
4747,2018,SC,DEPUTADO FEDERAL,MDB,12,7,19,0.3684210526315789,0.631578947368421
4748,2018,SC,DEPUTADO FEDERAL,PODE,3,3,6,0.5,0.5
4749,2018,SC,DEPUTADO FEDERAL,PSB,11,3,14,0.21428571428571427,0.7857142857142857
4750,2018,SC,DEPUTADO FEDERAL,PSL,13,6,19,0.3157894736842105,0.6842105263157895
4751,2018,SC,DEPUTADO FEDERAL,PSD,7,3,10,0.3,0.7
4752,2018,SC,DEPUTADO FEDERAL,PP,7,2,9,0.2222222222222222,0.7777777777777778
4753,2018,SC,DEPUTADO FEDERAL,NOVO,11,5,16,0.3125,0.6875
4754,2018,SC,DEPUTADO FEDERAL,PATRI,12,7,19,0.3684210526315789,0.631578947368421
4755,2018,SC,DEPUTADO FEDERAL,PSOL,11,6,17,0.35294117647058826,0.6470588235294118
4756,2018,SC,DEPUTADO FEDERAL,AVANTE,7,2,9,0.2222222222222222,0.7777777777777778
4757,2018,SC,DEPUTADO FEDERAL,PR,1,0,1,0.0,1.0
4758,2018,SC,DEPUTADO FEDERAL,PPS,1,1,2,0.5,0.5
4759,2018,SC,DEPUTADO FEDERAL,PSDB,11,6,17,0.35294117647058826,0.6470588235294118
4760,2018,SC,DEPUTADO FEDERAL,PC do B,0,1,1,1.0,0.0
4761,2018,SC,DEPUTADO FEDERAL,DEM,1,1,2,0.5,0.5
4762,2018,SC,DEPUTADO FEDERAL,PTC,15,8,23,0.34782608695652173,0.6521739130434783
4763,2018,SC,DEPUTADO FEDERAL,PSTU,1,1,2,0.5,0.5
4764,2018,SC,DEPUTADO FEDERAL,PT,8,4,12,0.3333333333333333,0.6666666666666666
4765,2018,SC,DEPUTADO FEDERAL,PRP,6,3,9,0.3333333333333333,0.6666666666666666
4766,2018,SC,DEPUTADO FEDERAL,REDE,4,2,6,0.3333333333333333,0.6666666666666666
4767,2018,SC,DEPUTADO FEDERAL,DC,1,0,1,0.0,1.0
4768,2018,SC,DEPUTADO FEDERAL,PRTB,3,3,6,0.5,0.5
4769,2018,SC,DEPUTADO FEDERAL,SOLIDARIEDADE,1,0,1,0.0,1.0
4770,2018,SC,DEPUTADO FEDERAL,PPL,2,0,2,0.0,1.0
4771,2018,SC,DEPUTADO FEDERAL,PMN,4,1,5,0.2,0.8
4772,2018,SC,DEPUTADO FEDERAL,PV,2,2,4,0.5,0.5
4773,2018,SC,DEPUTADO FEDERAL,PCB,3,0,3,0.0,1.0
4774,2018,SC,DEPUTADO FEDERAL,PSC,1,0,1,0.0,1.0
4775,2018,SC,DEPUTADO FEDERAL,PTB,1,0,1,0.0,1.0
4776,2018,SC,DEPUTADO FEDERAL,PROS,1,0,1,0.0,1.0
4777,2018,SC,DEPUTADO FEDERAL,PHS,2,1,3,0.3333333333333333,0.6666666666666666
4778,2018,SC,DEPUTADO FEDERAL,PCO,1,0,1,0.0,1.0
4779,2018,SC,DEPUTADO FEDERAL,PDT,1,0,1,0.0,1.0
4780,2018,SC,SENADOR,PSOL,2,0,2,0.0,1.0
4781,2018,SC,SENADOR,PSDB,1,0,1,0.0,1.0
4782,2018,SC,SENADOR,PP,1,0,1,0.0,1.0
4783,2018,SC,SENADOR,PR,1,0,1,0.0,1.0
4784,2018,SC,SENADOR,PT,1,1,2,0.5,0.5
4785,2018,SC,SENADOR,REDE,1,1,2,0.5,0.5
4786,2018,SC,SENADOR,PSTU,1,0,1,0.0,1.0
4787,2018,SC,SENADOR,PCO,0,1,1,1.0,0.0
4788,2018,SC,SENADOR,PSD,1,0,1,0.0,1.0
4789,2018,SC,SENADOR,PSL,1,0,1,0.0,1.0
4790,2018,SC,SENADOR,PMN,1,0,1,0.0,1.0
4791,2010,SP,DEPUTADO ESTADUAL,PSC,105,30,135,0.2222222222222222,0.7777777777777778
4792,2010,SP,DEPUTADO ESTADUAL,PT do B,22,8,30,0.26666666666666666,0.7333333333333333
4793,2010,SP,DEPUTADO ESTADUAL,PV,101,43,144,0.2986111111111111,0.7013888888888888
4794,2010,SP,DEPUTADO ESTADUAL,PTC,92,15,107,0.14018691588785046,0.8598130841121495
4795,2010,SP,DEPUTADO ESTADUAL,PTN,75,30,105,0.2857142857142857,0.7142857142857143
4796,2010,SP,DEPUTADO ESTADUAL,PSL,84,28,112,0.25,0.75
4797,2010,SP,DEPUTADO ESTADUAL,PP,74,7,81,0.08641975308641975,0.9135802469135802
4798,2010,SP,DEPUTADO ESTADUAL,PSOL,100,8,108,0.07407407407407407,0.9259259259259259
4799,2010,SP,DEPUTADO ESTADUAL,PPS,100,14,114,0.12280701754385964,0.8771929824561403
4800,2010,SP,DEPUTADO ESTADUAL,PRTB,34,2,36,0.05555555555555555,0.9444444444444444
4801,2010,SP,DEPUTADO ESTADUAL,PDT,71,5,76,0.06578947368421052,0.9342105263157895
4802,2010,SP,DEPUTADO ESTADUAL,PSDB,88,27,115,0.23478260869565218,0.7652173913043478
4803,2010,SP,DEPUTADO ESTADUAL,PC do B,75,11,86,0.12790697674418605,0.872093023255814
4804,2010,SP,DEPUTADO ESTADUAL,PMN,46,7,53,0.1320754716981132,0.8679245283018868
4805,2010,SP,DEPUTADO ESTADUAL,PSDC,40,4,44,0.09090909090909091,0.9090909090909091
4806,2010,SP,DEPUTADO ESTADUAL,PTB,96,26,122,0.21311475409836064,0.7868852459016393
4807,2010,SP,DEPUTADO ESTADUAL,PMDB,66,12,78,0.15384615384615385,0.8461538461538461
4808,2010,SP,DEPUTADO ESTADUAL,PT,81,22,103,0.21359223300970873,0.7864077669902912
4809,2010,SP,DEPUTADO ESTADUAL,PHS,21,0,21,0.0,1.0
4810,2010,SP,DEPUTADO ESTADUAL,PSB,92,43,135,0.31851851851851853,0.6814814814814815
4811,2010,SP,DEPUTADO ESTADUAL,PRP,42,9,51,0.17647058823529413,0.8235294117647058
4812,2010,SP,DEPUTADO ESTADUAL,PR,17,2,19,0.10526315789473684,0.8947368421052632
4813,2010,SP,DEPUTADO ESTADUAL,DEM,34,1,35,0.02857142857142857,0.9714285714285714
4814,2010,SP,DEPUTADO ESTADUAL,PSTU,27,16,43,0.37209302325581395,0.627906976744186
4815,2010,SP,DEPUTADO ESTADUAL,PRB,12,4,16,0.25,0.75
4816,2010,SP,DEPUTADO ESTADUAL,PCB,4,0,4,0.0,1.0
4817,2010,SP,DEPUTADO ESTADUAL,PCO,2,1,3,0.3333333333333333,0.6666666666666666
4818,2010,SP,DEPUTADO FEDERAL,PDT,46,4,50,0.08,0.92
4819,2010,SP,DEPUTADO FEDERAL,PTB,65,30,95,0.3157894736842105,0.6842105263157895
4820,2010,SP,DEPUTADO FEDERAL,PSDC,22,5,27,0.18518518518518517,0.8148148148148148
4821,2010,SP,DEPUTADO FEDERAL,PP,59,12,71,0.16901408450704225,0.8309859154929577
4822,2010,SP,DEPUTADO FEDERAL,PTC,70,29,99,0.29292929292929293,0.7070707070707071
4823,2010,SP,DEPUTADO FEDERAL,PSOL,70,23,93,0.24731182795698925,0.7526881720430108
4824,2010,SP,DEPUTADO FEDERAL,PMDB,63,5,68,0.07352941176470588,0.9264705882352942
4825,2010,SP,DEPUTADO FEDERAL,PSDB,47,5,52,0.09615384615384616,0.9038461538461539
4826,2010,SP,DEPUTADO FEDERAL,PSC,64,14,78,0.1794871794871795,0.8205128205128205
4827,2010,SP,DEPUTADO FEDERAL,DEM,30,1,31,0.03225806451612903,0.967741935483871
4828,2010,SP,DEPUTADO FEDERAL,PSB,57,28,85,0.32941176470588235,0.6705882352941176
4829,2010,SP,DEPUTADO FEDERAL,PR,6,1,7,0.14285714285714285,0.8571428571428571
4830,2010,SP,DEPUTADO FEDERAL,PT do B,11,0,11,0.0,1.0
4831,2010,SP,DEPUTADO FEDERAL,PMN,42,7,49,0.14285714285714285,0.8571428571428571
4832,2010,SP,DEPUTADO FEDERAL,PRTB,24,9,33,0.2727272727272727,0.7272727272727273
4833,2010,SP,DEPUTADO FEDERAL,PRB,15,0,15,0.0,1.0
4834,2010,SP,DEPUTADO FEDERAL,PV,70,31,101,0.3069306930693069,0.693069306930693
4835,2010,SP,DEPUTADO FEDERAL,PHS,40,9,49,0.1836734693877551,0.8163265306122449
4836,2010,SP,DEPUTADO FEDERAL,PCB,4,1,5,0.2,0.8
4837,2010,SP,DEPUTADO FEDERAL,PRP,32,5,37,0.13513513513513514,0.8648648648648649
4838,2010,SP,DEPUTADO FEDERAL,PTN,55,20,75,0.26666666666666666,0.7333333333333333
4839,2010,SP,DEPUTADO FEDERAL,PT,54,9,63,0.14285714285714285,0.8571428571428571
4840,2010,SP,DEPUTADO FEDERAL,PPS,21,4,25,0.16,0.84
4841,2010,SP,DEPUTADO FEDERAL,PC do B,11,0,11,0.0,1.0
4842,2010,SP,DEPUTADO FEDERAL,PSL,26,13,39,0.3333333333333333,0.6666666666666666
4843,2010,SP,DEPUTADO FEDERAL,PSTU,3,2,5,0.4,0.6
4844,2010,SP,DEPUTADO FEDERAL,PCO,1,1,2,0.5,0.5
4845,2010,SP,SENADOR,PCO,2,0,2,0.0,1.0
4846,2010,SP,SENADOR,PSB,1,0,1,0.0,1.0
4847,2010,SP,SENADOR,PSDB,1,0,1,0.0,1.0
4848,2010,SP,SENADOR,PSTU,1,1,2,0.5,0.5
4849,2010,SP,SENADOR,PCB,2,0,2,0.0,1.0
4850,2010,SP,SENADOR,PP,2,0,2,0.0,1.0
4851,2010,SP,SENADOR,PTC,1,0,1,0.0,1.0
4852,2010,SP,SENADOR,PC do B,1,0,1,0.0,1.0
4853,2010,SP,SENADOR,PSOL,1,0,1,0.0,1.0
4854,2010,SP,SENADOR,PT,0,1,1,1.0,0.0
4855,2010,SP,SENADOR,PSL,1,0,1,0.0,1.0
4856,2010,SP,SENADOR,PMDB,1,0,1,0.0,1.0
4857,2010,SP,SENADOR,PV,1,0,1,0.0,1.0
4858,2010,SP,SENADOR,PTB,1,0,1,0.0,1.0
4859,2014,SP,DEPUTADO ESTADUAL,PTB,99,43,142,0.3028169014084507,0.6971830985915493
4860,2014,SP,DEPUTADO ESTADUAL,PSDB,64,30,94,0.3191489361702128,0.6808510638297872
4861,2014,SP,DEPUTADO ESTADUAL,PC do B,64,27,91,0.2967032967032967,0.7032967032967034
4862,2014,SP,DEPUTADO ESTADUAL,PSD,33,15,48,0.3125,0.6875
4863,2014,SP,DEPUTADO ESTADUAL,PSC,59,26,85,0.3058823529411765,0.6941176470588235
4864,2014,SP,DEPUTADO ESTADUAL,PSB,89,38,127,0.2992125984251969,0.7007874015748031
4865,2014,SP,DEPUTADO ESTADUAL,PRTB,39,17,56,0.30357142857142855,0.6964285714285714
4866,2014,SP,DEPUTADO ESTADUAL,PSTU,34,18,52,0.34615384615384615,0.6538461538461539
4867,2014,SP,DEPUTADO ESTADUAL,PTN,33,14,47,0.2978723404255319,0.7021276595744681
4868,2014,SP,DEPUTADO ESTADUAL,PMDB,78,37,115,0.3217391304347826,0.6782608695652174
4869,2014,SP,DEPUTADO ESTADUAL,PSOL,77,31,108,0.28703703703703703,0.7129629629629629
4870,2014,SP,DEPUTADO ESTADUAL,PPL,29,15,44,0.3409090909090909,0.6590909090909091
4871,2014,SP,DEPUTADO ESTADUAL,PRB,14,6,20,0.3,0.7
4872,2014,SP,DEPUTADO ESTADUAL,PT do B,24,5,29,0.1724137931034483,0.8275862068965517
4873,2014,SP,DEPUTADO ESTADUAL,PEN,71,35,106,0.330188679245283,0.6698113207547169
4874,2014,SP,DEPUTADO ESTADUAL,PV,85,33,118,0.2796610169491525,0.7203389830508474
4875,2014,SP,DEPUTADO ESTADUAL,PPS,20,8,28,0.2857142857142857,0.7142857142857143
4876,2014,SP,DEPUTADO ESTADUAL,PDT,40,18,58,0.3103448275862069,0.6896551724137931
4877,2014,SP,DEPUTADO ESTADUAL,PT,72,33,105,0.3142857142857143,0.6857142857142857
4878,2014,SP,DEPUTADO ESTADUAL,PR,44,20,64,0.3125,0.6875
4879,2014,SP,DEPUTADO ESTADUAL,PMN,21,15,36,0.4166666666666667,0.5833333333333334
4880,2014,SP,DEPUTADO ESTADUAL,SD,29,15,44,0.3409090909090909,0.6590909090909091
4881,2014,SP,DEPUTADO ESTADUAL,PHS,94,41,135,0.3037037037037037,0.6962962962962963
4882,2014,SP,DEPUTADO ESTADUAL,PRP,94,43,137,0.31386861313868614,0.6861313868613139
4883,2014,SP,DEPUTADO ESTADUAL,PSL,26,12,38,0.3157894736842105,0.6842105263157895
4884,2014,SP,DEPUTADO ESTADUAL,PSDC,43,19,62,0.3064516129032258,0.6935483870967742
4885,2014,SP,DEPUTADO ESTADUAL,PTC,29,12,41,0.2926829268292683,0.7073170731707317
4886,2014,SP,DEPUTADO ESTADUAL,PP,14,6,20,0.3,0.7
4887,2014,SP,DEPUTADO ESTADUAL,DEM,22,7,29,0.2413793103448276,0.7586206896551724
4888,2014,SP,DEPUTADO ESTADUAL,PROS,30,13,43,0.3023255813953488,0.6976744186046512
4889,2014,SP,DEPUTADO ESTADUAL,PCO,3,2,5,0.4,0.6
4890,2014,SP,DEPUTADO FEDERAL,PSTU,1,10,11,0.9090909090909091,0.09090909090909091
4891,2014,SP,DEPUTADO FEDERAL,PSOL,72,23,95,0.24210526315789474,0.7578947368421053
4892,2014,SP,DEPUTADO FEDERAL,PRB,70,31,101,0.3069306930693069,0.693069306930693
4893,2014,SP,DEPUTADO FEDERAL,PSDB,39,19,58,0.3275862068965517,0.6724137931034483
4894,2014,SP,DEPUTADO FEDERAL,PV,73,35,108,0.32407407407407407,0.6759259259259259
4895,2014,SP,DEPUTADO FEDERAL,PMN,24,8,32,0.25,0.75
4896,2014,SP,DEPUTADO FEDERAL,PSL,19,10,29,0.3448275862068966,0.6551724137931034
4897,2014,SP,DEPUTADO FEDERAL,PSB,63,26,89,0.29213483146067415,0.7078651685393258
4898,2014,SP,DEPUTADO FEDERAL,PTC,24,9,33,0.2727272727272727,0.7272727272727273
4899,2014,SP,DEPUTADO FEDERAL,PT do B,14,6,20,0.3,0.7
4900,2014,SP,DEPUTADO FEDERAL,PEN,65,26,91,0.2857142857142857,0.7142857142857143
4901,2014,SP,DEPUTADO FEDERAL,PC do B,4,0,4,0.0,1.0
4902,2014,SP,DEPUTADO FEDERAL,PT,46,23,69,0.3333333333333333,0.6666666666666666
4903,2014,SP,DEPUTADO FEDERAL,PHS,54,21,75,0.28,0.72
4904,2014,SP,DEPUTADO FEDERAL,SD,29,15,44,0.3409090909090909,0.6590909090909091
4905,2014,SP,DEPUTADO FEDERAL,PTB,70,32,102,0.3137254901960784,0.6862745098039216
4906,2014,SP,DEPUTADO FEDERAL,PSDC,41,19,60,0.31666666666666665,0.6833333333333333
4907,2014,SP,DEPUTADO FEDERAL,PP,14,6,20,0.3,0.7
4908,2014,SP,DEPUTADO FEDERAL,PDT,35,15,50,0.3,0.7
4909,2014,SP,DEPUTADO FEDERAL,PR,25,11,36,0.3055555555555556,0.6944444444444444
4910,2014,SP,DEPUTADO FEDERAL,PMDB,59,31,90,0.34444444444444444,0.6555555555555556
4911,2014,SP,DEPUTADO FEDERAL,PSC,39,18,57,0.3157894736842105,0.6842105263157895
4912,2014,SP,DEPUTADO FEDERAL,PPS,10,5,15,0.3333333333333333,0.6666666666666666
4913,2014,SP,DEPUTADO FEDERAL,PRTB,27,12,39,0.3076923076923077,0.6923076923076923
4914,2014,SP,DEPUTADO FEDERAL,PRP,46,21,67,0.31343283582089554,0.6865671641791045
4915,2014,SP,DEPUTADO FEDERAL,PTN,16,10,26,0.38461538461538464,0.6153846153846154
4916,2014,SP,DEPUTADO FEDERAL,DEM,11,5,16,0.3125,0.6875
4917,2014,SP,DEPUTADO FEDERAL,PCO,3,2,5,0.4,0.6
4918,2014,SP,DEPUTADO FEDERAL,PSD,15,8,23,0.34782608695652173,0.6521739130434783
4919,2014,SP,DEPUTADO FEDERAL,PROS,7,3,10,0.3,0.7
4920,2014,SP,DEPUTADO FEDERAL,PCB,3,3,6,0.5,0.5
4921,2014,SP,DEPUTADO FEDERAL,PPL,2,1,3,0.3333333333333333,0.6666666666666666
4922,2014,SP,SENADOR,PSD,1,0,1,0.0,1.0
4923,2014,SP,SENADOR,PCB,1,0,1,0.0,1.0
4924,2014,SP,SENADOR,PT,1,0,1,0.0,1.0
4925,2014,SP,SENADOR,PSB,1,0,1,0.0,1.0
4926,2014,SP,SENADOR,PRTB,1,0,1,0.0,1.0
4927,2014,SP,SENADOR,PRP,1,0,1,0.0,1.0
4928,2014,SP,SENADOR,PSTU,0,1,1,1.0,0.0
4929,2014,SP,SENADOR,PTB,0,1,1,1.0,0.0
4930,2014,SP,SENADOR,PSDB,1,0,1,0.0,1.0
4931,2014,SP,SENADOR,PV,1,0,1,0.0,1.0
4932,2014,SP,SENADOR,PCO,1,0,1,0.0,1.0
4933,2018,SP,DEPUTADO ESTADUAL,AVANTE,96,45,141,0.3191489361702128,0.6808510638297872
4934,2018,SP,DEPUTADO ESTADUAL,PROS,100,43,143,0.3006993006993007,0.6993006993006993
4935,2018,SP,DEPUTADO ESTADUAL,PRTB,45,20,65,0.3076923076923077,0.6923076923076923
4936,2018,SP,DEPUTADO ESTADUAL,PSDB,38,17,55,0.3090909090909091,0.6909090909090909
4937,2018,SP,DEPUTADO ESTADUAL,PRP,75,34,109,0.3119266055045872,0.6880733944954128
4938,2018,SP,DEPUTADO ESTADUAL,PMB,16,15,31,0.4838709677419355,0.5161290322580645
4939,2018,SP,DEPUTADO ESTADUAL,SOLIDARIEDADE,31,18,49,0.3673469387755102,0.6326530612244898
4940,2018,SP,DEPUTADO ESTADUAL,MDB,42,21,63,0.3333333333333333,0.6666666666666666
4941,2018,SP,DEPUTADO ESTADUAL,REDE,33,16,49,0.32653061224489793,0.673469387755102
4942,2018,SP,DEPUTADO ESTADUAL,PATRI,97,44,141,0.3120567375886525,0.6879432624113475
4943,2018,SP,DEPUTADO ESTADUAL,PHS,78,32,110,0.2909090909090909,0.7090909090909091
4944,2018,SP,DEPUTADO ESTADUAL,PODE,101,43,144,0.2986111111111111,0.7013888888888888
4945,2018,SP,DEPUTADO ESTADUAL,PR,67,33,100,0.33,0.67
4946,2018,SP,DEPUTADO ESTADUAL,NOVO,34,16,50,0.32,0.68
4947,2018,SP,DEPUTADO ESTADUAL,PTB,14,9,23,0.391304347826087,0.6086956521739131
4948,2018,SP,DEPUTADO ESTADUAL,PSC,14,5,19,0.2631578947368421,0.7368421052631579
4949,2018,SP,DEPUTADO ESTADUAL,PV,18,10,28,0.35714285714285715,0.6428571428571429
4950,2018,SP,DEPUTADO ESTADUAL,PPL,16,8,24,0.3333333333333333,0.6666666666666666
4951,2018,SP,DEPUTADO ESTADUAL,PC do B,59,27,86,0.313953488372093,0.686046511627907
4952,2018,SP,DEPUTADO ESTADUAL,PT,68,33,101,0.32673267326732675,0.6732673267326733
4953,2018,SP,DEPUTADO ESTADUAL,PSL,86,43,129,0.3333333333333333,0.6666666666666666
4954,2018,SP,DEPUTADO ESTADUAL,PDT,47,22,69,0.3188405797101449,0.6811594202898551
4955,2018,SP,DEPUTADO ESTADUAL,PPS,9,4,13,0.3076923076923077,0.6923076923076923
4956,2018,SP,DEPUTADO ESTADUAL,PSOL,58,29,87,0.3333333333333333,0.6666666666666666
4957,2018,SP,DEPUTADO ESTADUAL,PSD,20,13,33,0.3939393939393939,0.6060606060606061
4958,2018,SP,DEPUTADO ESTADUAL,PMN,44,21,65,0.3230769230769231,0.676923076923077
4959,2018,SP,DEPUTADO ESTADUAL,PSTU,13,10,23,0.43478260869565216,0.5652173913043478
4960,2018,SP,DEPUTADO ESTADUAL,PRB,16,7,23,0.30434782608695654,0.6956521739130435
4961,2018,SP,DEPUTADO ESTADUAL,DC,40,19,59,0.3220338983050847,0.6779661016949152
4962,2018,SP,DEPUTADO ESTADUAL,PTC,32,13,45,0.28888888888888886,0.7111111111111111
4963,2018,SP,DEPUTADO ESTADUAL,DEM,13,4,17,0.23529411764705882,0.7647058823529411
4964,2018,SP,DEPUTADO ESTADUAL,PP,12,2,14,0.14285714285714285,0.8571428571428571
4965,2018,SP,DEPUTADO ESTADUAL,PSB,35,16,51,0.3137254901960784,0.6862745098039216
4966,2018,SP,DEPUTADO ESTADUAL,PCO,5,2,7,0.2857142857142857,0.7142857142857143
4967,2018,SP,DEPUTADO ESTADUAL,PCB,1,0,1,0.0,1.0
4968,2018,SP,DEPUTADO FEDERAL,AVANTE,70,30,100,0.3,0.7
4969,2018,SP,DEPUTADO FEDERAL,PSDB,40,22,62,0.3548387096774194,0.6451612903225806
4970,2018,SP,DEPUTADO FEDERAL,SOLIDARIEDADE,32,16,48,0.3333333333333333,0.6666666666666666
4971,2018,SP,DEPUTADO FEDERAL,PRB,71,31,102,0.30392156862745096,0.696078431372549
4972,2018,SP,DEPUTADO FEDERAL,PROS,71,30,101,0.297029702970297,0.7029702970297029
4973,2018,SP,DEPUTADO FEDERAL,DC,40,19,59,0.3220338983050847,0.6779661016949152
4974,2018,SP,DEPUTADO FEDERAL,PT,56,25,81,0.30864197530864196,0.691358024691358
4975,2018,SP,DEPUTADO FEDERAL,PSOL,58,26,84,0.30952380952380953,0.6904761904761905
4976,2018,SP,DEPUTADO FEDERAL,PRP,58,25,83,0.30120481927710846,0.6987951807228916
4977,2018,SP,DEPUTADO FEDERAL,PATRI,71,30,101,0.297029702970297,0.7029702970297029
4978,2018,SP,DEPUTADO FEDERAL,NOVO,30,17,47,0.3617021276595745,0.6382978723404256
4979,2018,SP,DEPUTADO FEDERAL,PTC,27,14,41,0.34146341463414637,0.6585365853658537
4980,2018,SP,DEPUTADO FEDERAL,PODE,57,23,80,0.2875,0.7125
4981,2018,SP,DEPUTADO FEDERAL,PR,31,15,46,0.32608695652173914,0.6739130434782609
4982,2018,SP,DEPUTADO FEDERAL,PTB,16,12,28,0.42857142857142855,0.5714285714285714
4983,2018,SP,DEPUTADO FEDERAL,PP,5,1,6,0.16666666666666666,0.8333333333333334
4984,2018,SP,DEPUTADO FEDERAL,PMB,7,6,13,0.46153846153846156,0.5384615384615384
4985,2018,SP,DEPUTADO FEDERAL,PRTB,43,19,62,0.3064516129032258,0.6935483870967742
4986,2018,SP,DEPUTADO FEDERAL,PSB,37,16,53,0.3018867924528302,0.6981132075471698
4987,2018,SP,DEPUTADO FEDERAL,PSL,46,21,67,0.31343283582089554,0.6865671641791045
4988,2018,SP,DEPUTADO FEDERAL,MDB,43,21,64,0.328125,0.671875
4989,2018,SP,DEPUTADO FEDERAL,REDE,22,10,32,0.3125,0.6875
4990,2018,SP,DEPUTADO FEDERAL,PV,60,27,87,0.3103448275862069,0.6896551724137931
4991,2018,SP,DEPUTADO FEDERAL,PSD,15,7,22,0.3181818181818182,0.6818181818181818
4992,2018,SP,DEPUTADO FEDERAL,PMN,40,18,58,0.3103448275862069,0.6896551724137931
4993,2018,SP,DEPUTADO FEDERAL,PPS,9,2,11,0.18181818181818182,0.8181818181818182
4994,2018,SP,DEPUTADO FEDERAL,PPL,42,18,60,0.3,0.7
4995,2018,SP,DEPUTADO FEDERAL,PHS,9,5,14,0.35714285714285715,0.6428571428571429
4996,2018,SP,DEPUTADO FEDERAL,PCO,7,3,10,0.3,0.7
4997,2018,SP,DEPUTADO FEDERAL,DEM,11,3,14,0.21428571428571427,0.7857142857142857
4998,2018,SP,DEPUTADO FEDERAL,PDT,22,10,32,0.3125,0.6875
4999,2018,SP,DEPUTADO FEDERAL,PSTU,4,3,7,0.42857142857142855,0.5714285714285714
5000,2018,SP,DEPUTADO FEDERAL,PSC,3,0,3,0.0,1.0
5001,2018,SP,DEPUTADO FEDERAL,PC do B,1,1,2,0.5,0.5
5002,2018,SP,DEPUTADO FEDERAL,PCB,1,1,2,0.5,0.5
5003,2018,SP,SENADOR,REDE,1,1,2,0.5,0.5
5004,2018,SP,SENADOR,PSDB,1,1,2,0.5,0.5
5005,2018,SP,SENADOR,PSB,0,1,1,1.0,0.0
5006,2018,SP,SENADOR,PSOL,1,1,2,0.5,0.5
5007,2018,SP,SENADOR,PSTU,1,1,2,0.5,0.5
5008,2018,SP,SENADOR,PCO,1,0,1,0.0,1.0
5009,2018,SP,SENADOR,MDB,1,1,2,0.5,0.5
5010,2018,SP,SENADOR,PRTB,1,0,1,0.0,1.0
5011,2018,SP,SENADOR,PSL,1,0,1,0.0,1.0
5012,2018,SP,SENADOR,NOVO,1,0,1,0.0,1.0
5013,2018,SP,SENADOR,PODE,1,0,1,0.0,1.0
5014,2018,SP,SENADOR,PDT,1,0,1,0.0,1.0
5015,2018,SP,SENADOR,DC,1,0,1,0.0,1.0
5016,2018,SP,SENADOR,PT,2,0,2,0.0,1.0
5017,2010,SE,DEPUTADO ESTADUAL,PSB,3,1,4,0.25,0.75
5018,2010,SE,DEPUTADO ESTADUAL,PSOL,4,0,4,0.0,1.0
5019,2010,SE,DEPUTADO ESTADUAL,PTC,12,0,12,0.0,1.0
5020,2010,SE,DEPUTADO ESTADUAL,PT do B,13,5,18,0.2777777777777778,0.7222222222222222
5021,2010,SE,DEPUTADO ESTADUAL,PT,4,2,6,0.3333333333333333,0.6666666666666666
5022,2010,SE,DEPUTADO ESTADUAL,PV,15,1,16,0.0625,0.9375
5023,2010,SE,DEPUTADO ESTADUAL,PCB,3,1,4,0.25,0.75
5024,2010,SE,DEPUTADO ESTADUAL,PSC,3,2,5,0.4,0.6
5025,2010,SE,DEPUTADO ESTADUAL,DEM,11,3,14,0.21428571428571427,0.7857142857142857
5026,2010,SE,DEPUTADO ESTADUAL,PSDB,4,3,7,0.42857142857142855,0.5714285714285714
5027,2010,SE,DEPUTADO ESTADUAL,PTB,3,0,3,0.0,1.0
5028,2010,SE,DEPUTADO ESTADUAL,PRP,2,1,3,0.3333333333333333,0.6666666666666666
5029,2010,SE,DEPUTADO ESTADUAL,PRTB,2,0,2,0.0,1.0
5030,2010,SE,DEPUTADO ESTADUAL,PPS,12,1,13,0.07692307692307693,0.9230769230769231
5031,2010,SE,DEPUTADO ESTADUAL,PDT,4,0,4,0.0,1.0
5032,2010,SE,DEPUTADO ESTADUAL,PSDC,2,0,2,0.0,1.0
5033,2010,SE,DEPUTADO ESTADUAL,PR,2,0,2,0.0,1.0
5034,2010,SE,DEPUTADO ESTADUAL,PSL,5,0,5,0.0,1.0
5035,2010,SE,DEPUTADO ESTADUAL,PRB,3,0,3,0.0,1.0
5036,2010,SE,DEPUTADO ESTADUAL,PMDB,5,0,5,0.0,1.0
5037,2010,SE,DEPUTADO ESTADUAL,PP,2,0,2,0.0,1.0
5038,2010,SE,DEPUTADO ESTADUAL,PHS,2,1,3,0.3333333333333333,0.6666666666666666
5039,2010,SE,DEPUTADO ESTADUAL,PSTU,1,0,1,0.0,1.0
5040,2010,SE,DEPUTADO ESTADUAL,PC do B,0,1,1,1.0,0.0
5041,2010,SE,DEPUTADO ESTADUAL,PMN,2,0,2,0.0,1.0
5042,2010,SE,DEPUTADO FEDERAL,PRTB,2,1,3,0.3333333333333333,0.6666666666666666
5043,2010,SE,DEPUTADO FEDERAL,PC do B,1,0,1,0.0,1.0
5044,2010,SE,DEPUTADO FEDERAL,PMDB,4,0,4,0.0,1.0
5045,2010,SE,DEPUTADO FEDERAL,PSC,2,1,3,0.3333333333333333,0.6666666666666666
5046,2010,SE,DEPUTADO FEDERAL,DEM,7,3,10,0.3,0.7
5047,2010,SE,DEPUTADO FEDERAL,PSB,1,0,1,0.0,1.0
5048,2010,SE,DEPUTADO FEDERAL,PP,2,2,4,0.5,0.5
5049,2010,SE,DEPUTADO FEDERAL,PTB,1,0,1,0.0,1.0
5050,2010,SE,DEPUTADO FEDERAL,PV,9,2,11,0.18181818181818182,0.8181818181818182
5051,2010,SE,DEPUTADO FEDERAL,PT do B,3,0,3,0.0,1.0
5052,2010,SE,DEPUTADO FEDERAL,PCB,3,0,3,0.0,1.0
5053,2010,SE,DEPUTADO FEDERAL,PSDB,2,1,3,0.3333333333333333,0.6666666666666666
5054,2010,SE,DEPUTADO FEDERAL,PMN,1,0,1,0.0,1.0
5055,2010,SE,DEPUTADO FEDERAL,PDT,3,0,3,0.0,1.0
5056,2010,SE,DEPUTADO FEDERAL,PSTU,1,0,1,0.0,1.0
5057,2010,SE,DEPUTADO FEDERAL,PRB,1,0,1,0.0,1.0
5058,2010,SE,DEPUTADO FEDERAL,PT,3,0,3,0.0,1.0
5059,2010,SE,DEPUTADO FEDERAL,PPS,5,0,5,0.0,1.0
5060,2010,SE,DEPUTADO FEDERAL,PR,1,0,1,0.0,1.0
5061,2010,SE,DEPUTADO FEDERAL,PSOL,1,0,1,0.0,1.0
5062,2010,SE,DEPUTADO FEDERAL,PRP,1,0,1,0.0,1.0
5063,2010,SE,DEPUTADO FEDERAL,PHS,0,1,1,1.0,0.0
5064,2010,SE,SENADOR,PSDB,1,0,1,0.0,1.0
5065,2010,SE,SENADOR,PSB,1,0,1,0.0,1.0
5066,2010,SE,SENADOR,PV,1,0,1,0.0,1.0
5067,2010,SE,SENADOR,PSTU,1,1,2,0.5,0.5
5068,2010,SE,SENADOR,PSC,1,0,1,0.0,1.0
5069,2010,SE,SENADOR,PPS,1,0,1,0.0,1.0
5070,2010,SE,SENADOR,PCB,2,0,2,0.0,1.0
5071,2010,SE,SENADOR,PSOL,1,0,1,0.0,1.0
5072,2010,SE,SENADOR,DEM,1,0,1,0.0,1.0
5073,2010,SE,SENADOR,PSDC,1,0,1,0.0,1.0
5074,2010,SE,SENADOR,PRTB,2,0,2,0.0,1.0
5075,2014,SE,DEPUTADO ESTADUAL,PMN,7,6,13,0.46153846153846156,0.5384615384615384
5076,2014,SE,DEPUTADO ESTADUAL,PDT,2,4,6,0.6666666666666666,0.3333333333333333
5077,2014,SE,DEPUTADO ESTADUAL,PSOL,6,3,9,0.3333333333333333,0.6666666666666666
5078,2014,SE,DEPUTADO ESTADUAL,PROS,6,2,8,0.25,0.75
5079,2014,SE,DEPUTADO ESTADUAL,PSC,5,4,9,0.4444444444444444,0.5555555555555556
5080,2014,SE,DEPUTADO ESTADUAL,PHS,1,0,1,0.0,1.0
5081,2014,SE,DEPUTADO ESTADUAL,PV,4,3,7,0.42857142857142855,0.5714285714285714
5082,2014,SE,DEPUTADO ESTADUAL,DEM,8,4,12,0.3333333333333333,0.6666666666666666
5083,2014,SE,DEPUTADO ESTADUAL,PEN,11,3,14,0.21428571428571427,0.7857142857142857
5084,2014,SE,DEPUTADO ESTADUAL,PTC,8,2,10,0.2,0.8
5085,2014,SE,DEPUTADO ESTADUAL,PMDB,8,5,13,0.38461538461538464,0.6153846153846154
5086,2014,SE,DEPUTADO ESTADUAL,PRP,2,2,4,0.5,0.5
5087,2014,SE,DEPUTADO ESTADUAL,PSL,9,2,11,0.18181818181818182,0.8181818181818182
5088,2014,SE,DEPUTADO ESTADUAL,PRB,6,1,7,0.14285714285714285,0.8571428571428571
5089,2014,SE,DEPUTADO ESTADUAL,PSDB,5,2,7,0.2857142857142857,0.7142857142857143
5090,2014,SE,DEPUTADO ESTADUAL,SD,3,2,5,0.4,0.6
5091,2014,SE,DEPUTADO ESTADUAL,PPS,3,0,3,0.0,1.0
5092,2014,SE,DEPUTADO ESTADUAL,PC do B,3,2,5,0.4,0.6
5093,2014,SE,DEPUTADO ESTADUAL,PSB,4,2,6,0.3333333333333333,0.6666666666666666
5094,2014,SE,DEPUTADO ESTADUAL,PR,3,2,5,0.4,0.6
5095,2014,SE,DEPUTADO ESTADUAL,PSD,5,1,6,0.16666666666666666,0.8333333333333334
5096,2014,SE,DEPUTADO ESTADUAL,PPL,3,2,5,0.4,0.6
5097,2014,SE,DEPUTADO ESTADUAL,PT,5,3,8,0.375,0.625
5098,2014,SE,DEPUTADO ESTADUAL,PSTU,3,2,5,0.4,0.6
5099,2014,SE,DEPUTADO ESTADUAL,PP,1,1,2,0.5,0.5
5100,2014,SE,DEPUTADO ESTADUAL,PTB,2,2,4,0.5,0.5
5101,2014,SE,DEPUTADO ESTADUAL,PT do B,1,0,1,0.0,1.0
5102,2014,SE,DEPUTADO FEDERAL,PSD,3,0,3,0.0,1.0
5103,2014,SE,DEPUTADO FEDERAL,PPL,2,2,4,0.5,0.5
5104,2014,SE,DEPUTADO FEDERAL,PROS,1,1,2,0.5,0.5
5105,2014,SE,DEPUTADO FEDERAL,PV,3,1,4,0.25,0.75
5106,2014,SE,DEPUTADO FEDERAL,PRTB,6,3,9,0.3333333333333333,0.6666666666666666
5107,2014,SE,DEPUTADO FEDERAL,SD,2,0,2,0.0,1.0
5108,2014,SE,DEPUTADO FEDERAL,PT,4,1,5,0.2,0.8
5109,2014,SE,DEPUTADO FEDERAL,PP,2,1,3,0.3333333333333333,0.6666666666666666
5110,2014,SE,DEPUTADO FEDERAL,PSOL,7,2,9,0.2222222222222222,0.7777777777777778
5111,2014,SE,DEPUTADO FEDERAL,PR,0,2,2,1.0,0.0
5112,2014,SE,DEPUTADO FEDERAL,PDT,3,1,4,0.25,0.75
5113,2014,SE,DEPUTADO FEDERAL,PPS,3,0,3,0.0,1.0
5114,2014,SE,DEPUTADO FEDERAL,PHS,0,1,1,1.0,0.0
5115,2014,SE,DEPUTADO FEDERAL,PSDB,4,1,5,0.2,0.8
5116,2014,SE,DEPUTADO FEDERAL,PMN,6,3,9,0.3333333333333333,0.6666666666666666
5117,2014,SE,DEPUTADO FEDERAL,DEM,1,2,3,0.6666666666666666,0.3333333333333333
5118,2014,SE,DEPUTADO FEDERAL,PMDB,2,1,3,0.3333333333333333,0.6666666666666666
5119,2014,SE,DEPUTADO FEDERAL,PRP,1,1,2,0.5,0.5
5120,2014,SE,DEPUTADO FEDERAL,PSC,2,0,2,0.0,1.0
5121,2014,SE,DEPUTADO FEDERAL,PSL,0,1,1,1.0,0.0
5122,2014,SE,DEPUTADO FEDERAL,PRB,1,1,2,0.5,0.5
5123,2014,SE,DEPUTADO FEDERAL,PTB,1,0,1,0.0,1.0
5124,2014,SE,DEPUTADO FEDERAL,PTN,1,0,1,0.0,1.0
5125,2014,SE,DEPUTADO FEDERAL,PEN,1,1,2,0.5,0.5
5126,2014,SE,DEPUTADO FEDERAL,PSB,2,0,2,0.0,1.0
5127,2014,SE,DEPUTADO FEDERAL,PCB,2,1,3,0.3333333333333333,0.6666666666666666
5128,2014,SE,DEPUTADO FEDERAL,PSTU,0,1,1,1.0,0.0
5129,2014,SE,DEPUTADO FEDERAL,PC do B,0,1,1,1.0,0.0
5130,2014,SE,SENADOR,PT,1,0,1,0.0,1.0
5131,2014,SE,SENADOR,PSTU,1,0,1,0.0,1.0
5132,2014,SE,SENADOR,DEM,0,1,1,1.0,0.0
5133,2014,SE,SENADOR,PPL,1,0,1,0.0,1.0
5134,2014,SE,SENADOR,PCB,1,0,1,0.0,1.0
5135,2018,SE,DEPUTADO ESTADUAL,PRP,2,4,6,0.6666666666666666,0.3333333333333333
5136,2018,SE,DEPUTADO ESTADUAL,PT,9,4,13,0.3076923076923077,0.6923076923076923
5137,2018,SE,DEPUTADO ESTADUAL,PSL,12,8,20,0.4,0.6
5138,2018,SE,DEPUTADO ESTADUAL,PV,14,7,21,0.3333333333333333,0.6666666666666666
5139,2018,SE,DEPUTADO ESTADUAL,PMN,12,9,21,0.42857142857142855,0.5714285714285714
5140,2018,SE,DEPUTADO ESTADUAL,PSOL,7,3,10,0.3,0.7
5141,2018,SE,DEPUTADO ESTADUAL,PODE,4,3,7,0.42857142857142855,0.5714285714285714
5142,2018,SE,DEPUTADO ESTADUAL,PMB,1,0,1,0.0,1.0
5143,2018,SE,DEPUTADO ESTADUAL,PTB,12,4,16,0.25,0.75
5144,2018,SE,DEPUTADO ESTADUAL,PRB,5,1,6,0.16666666666666666,0.8333333333333334
5145,2018,SE,DEPUTADO ESTADUAL,PSC,8,1,9,0.1111111111111111,0.8888888888888888
5146,2018,SE,DEPUTADO ESTADUAL,REDE,24,12,36,0.3333333333333333,0.6666666666666666
5147,2018,SE,DEPUTADO ESTADUAL,AVANTE,10,2,12,0.16666666666666666,0.8333333333333334
5148,2018,SE,DEPUTADO ESTADUAL,PROS,2,0,2,0.0,1.0
5149,2018,SE,DEPUTADO ESTADUAL,PC do B,6,3,9,0.3333333333333333,0.6666666666666666
5150,2018,SE,DEPUTADO ESTADUAL,PSDB,3,5,8,0.625,0.375
5151,2018,SE,DEPUTADO ESTADUAL,PTC,9,7,16,0.4375,0.5625
5152,2018,SE,DEPUTADO ESTADUAL,PATRI,7,1,8,0.125,0.875
5153,2018,SE,DEPUTADO ESTADUAL,PSB,14,7,21,0.3333333333333333,0.6666666666666666
5154,2018,SE,DEPUTADO ESTADUAL,PSD,5,3,8,0.375,0.625
5155,2018,SE,DEPUTADO ESTADUAL,MDB,4,4,8,0.5,0.5
5156,2018,SE,DEPUTADO ESTADUAL,DEM,10,7,17,0.4117647058823529,0.5882352941176471
5157,2018,SE,DEPUTADO ESTADUAL,PCB,2,1,3,0.3333333333333333,0.6666666666666666
5158,2018,SE,DEPUTADO ESTADUAL,PSTU,1,0,1,0.0,1.0
5159,2018,SE,DEPUTADO ESTADUAL,PP,2,0,2,0.0,1.0
5160,2018,SE,DEPUTADO ESTADUAL,PR,2,1,3,0.3333333333333333,0.6666666666666666
5161,2018,SE,DEPUTADO ESTADUAL,PPS,21,5,26,0.19230769230769232,0.8076923076923077
5162,2018,SE,DEPUTADO ESTADUAL,PDT,5,1,6,0.16666666666666666,0.8333333333333334
5163,2018,SE,DEPUTADO ESTADUAL,PPL,4,4,8,0.5,0.5
5164,2018,SE,DEPUTADO ESTADUAL,PRTB,4,1,5,0.2,0.8
5165,2018,SE,DEPUTADO ESTADUAL,SOLIDARIEDADE,2,2,4,0.5,0.5
5166,2018,SE,DEPUTADO FEDERAL,SOLIDARIEDADE,1,1,2,0.5,0.5
5167,2018,SE,DEPUTADO FEDERAL,PV,6,4,10,0.4,0.6
5168,2018,SE,DEPUTADO FEDERAL,REDE,9,4,13,0.3076923076923077,0.6923076923076923
5169,2018,SE,DEPUTADO FEDERAL,PCB,2,1,3,0.3333333333333333,0.6666666666666666
5170,2018,SE,DEPUTADO FEDERAL,PSB,5,1,6,0.16666666666666666,0.8333333333333334
5171,2018,SE,DEPUTADO FEDERAL,PROS,1,0,1,0.0,1.0
5172,2018,SE,DEPUTADO FEDERAL,AVANTE,4,2,6,0.3333333333333333,0.6666666666666666
5173,2018,SE,DEPUTADO FEDERAL,NOVO,1,1,2,0.5,0.5
5174,2018,SE,DEPUTADO FEDERAL,PSOL,7,3,10,0.3,0.7
5175,2018,SE,DEPUTADO FEDERAL,PT,2,1,3,0.3333333333333333,0.6666666666666666
5176,2018,SE,DEPUTADO FEDERAL,PSDB,2,1,3,0.3333333333333333,0.6666666666666666
5177,2018,SE,DEPUTADO FEDERAL,PSL,8,3,11,0.2727272727272727,0.7272727272727273
5178,2018,SE,DEPUTADO FEDERAL,DEM,4,1,5,0.2,0.8
5179,2018,SE,DEPUTADO FEDERAL,PODE,3,1,4,0.25,0.75
5180,2018,SE,DEPUTADO FEDERAL,PRB,1,1,2,0.5,0.5
5181,2018,SE,DEPUTADO FEDERAL,PTB,2,0,2,0.0,1.0
5182,2018,SE,DEPUTADO FEDERAL,PSC,2,0,2,0.0,1.0
5183,2018,SE,DEPUTADO FEDERAL,PMN,3,1,4,0.25,0.75
5184,2018,SE,DEPUTADO FEDERAL,PRTB,2,1,3,0.3333333333333333,0.6666666666666666
5185,2018,SE,DEPUTADO FEDERAL,PSD,1,0,1,0.0,1.0
5186,2018,SE,DEPUTADO FEDERAL,MDB,2,1,3,0.3333333333333333,0.6666666666666666
5187,2018,SE,DEPUTADO FEDERAL,PPL,1,2,3,0.6666666666666666,0.3333333333333333
5188,2018,SE,DEPUTADO FEDERAL,PDT,1,2,3,0.6666666666666666,0.3333333333333333
5189,2018,SE,DEPUTADO FEDERAL,PSTU,1,1,2,0.5,0.5
5190,2018,SE,DEPUTADO FEDERAL,DC,2,1,3,0.3333333333333333,0.6666666666666666
5191,2018,SE,DEPUTADO FEDERAL,PPS,2,0,2,0.0,1.0
5192,2018,SE,DEPUTADO FEDERAL,PR,2,2,4,0.5,0.5
5193,2018,SE,DEPUTADO FEDERAL,PC do B,1,1,2,0.5,0.5
5194,2018,SE,DEPUTADO FEDERAL,PHS,2,1,3,0.3333333333333333,0.6666666666666666
5195,2018,SE,DEPUTADO FEDERAL,PATRI,1,1,2,0.5,0.5
5196,2018,SE,DEPUTADO FEDERAL,PP,1,0,1,0.0,1.0
5197,2018,SE,DEPUTADO FEDERAL,PTC,1,0,1,0.0,1.0
5198,2018,SE,DEPUTADO FEDERAL,PRP,1,0,1,0.0,1.0
5199,2018,SE,SENADOR,PV,1,0,1,0.0,1.0
5200,2018,SE,SENADOR,PT,1,0,1,0.0,1.0
5201,2018,SE,SENADOR,PRB,1,0,1,0.0,1.0
5202,2018,SE,SENADOR,PSC,1,0,1,0.0,1.0
5203,2018,SE,SENADOR,PSB,1,0,1,0.0,1.0
5204,2018,SE,SENADOR,PSOL,1,1,2,0.5,0.5
5205,2018,SE,SENADOR,PSL,1,0,1,0.0,1.0
5206,2018,SE,SENADOR,PATRI,1,0,1,0.0,1.0
5207,2018,SE,SENADOR,MDB,1,0,1,0.0,1.0
5208,2018,SE,SENADOR,PPL,1,0,1,0.0,1.0
5209,2018,SE,SENADOR,REDE,1,0,1,0.0,1.0
5210,2018,SE,SENADOR,PSTU,1,0,1,0.0,1.0
5211,2018,SE,SENADOR,PMB,1,0,1,0.0,1.0
5212,2010,TO,DEPUTADO ESTADUAL,PSDB,25,2,27,0.07407407407407407,0.9259259259259259
5213,2010,TO,DEPUTADO ESTADUAL,PPS,10,0,10,0.0,1.0
5214,2010,TO,DEPUTADO ESTADUAL,PT,25,6,31,0.1935483870967742,0.8064516129032258
5215,2010,TO,DEPUTADO ESTADUAL,PR,15,3,18,0.16666666666666666,0.8333333333333334
5216,2010,TO,DEPUTADO ESTADUAL,PMN,1,2,3,0.6666666666666666,0.3333333333333333
5217,2010,TO,DEPUTADO ESTADUAL,PRP,7,3,10,0.3,0.7
5218,2010,TO,DEPUTADO ESTADUAL,PDT,5,1,6,0.16666666666666666,0.8333333333333334
5219,2010,TO,DEPUTADO ESTADUAL,PSDC,4,1,5,0.2,0.8
5220,2010,TO,DEPUTADO ESTADUAL,PP,6,0,6,0.0,1.0
5221,2010,TO,DEPUTADO ESTADUAL,PMDB,15,2,17,0.11764705882352941,0.8823529411764706
5222,2010,TO,DEPUTADO ESTADUAL,PV,9,1,10,0.1,0.9
5223,2010,TO,DEPUTADO ESTADUAL,PC do B,8,1,9,0.1111111111111111,0.8888888888888888
5224,2010,TO,DEPUTADO ESTADUAL,DEM,21,6,27,0.2222222222222222,0.7777777777777778
5225,2010,TO,DEPUTADO ESTADUAL,PSB,16,2,18,0.1111111111111111,0.8888888888888888
5226,2010,TO,DEPUTADO ESTADUAL,PSL,4,0,4,0.0,1.0
5227,2010,TO,DEPUTADO ESTADUAL,PHS,1,0,1,0.0,1.0
5228,2010,TO,DEPUTADO ESTADUAL,PSC,5,1,6,0.16666666666666666,0.8333333333333334
5229,2010,TO,DEPUTADO ESTADUAL,PTC,2,0,2,0.0,1.0
5230,2010,TO,DEPUTADO ESTADUAL,PTB,7,1,8,0.125,0.875
5231,2010,TO,DEPUTADO ESTADUAL,PRTB,1,0,1,0.0,1.0
5232,2010,TO,DEPUTADO ESTADUAL,PTN,3,0,3,0.0,1.0
5233,2010,TO,DEPUTADO ESTADUAL,PT do B,3,1,4,0.25,0.75
5234,2010,TO,DEPUTADO ESTADUAL,PRB,5,1,6,0.16666666666666666,0.8333333333333334
5235,2010,TO,DEPUTADO FEDERAL,PSC,2,0,2,0.0,1.0
5236,2010,TO,DEPUTADO FEDERAL,PR,5,2,7,0.2857142857142857,0.7142857142857143
5237,2010,TO,DEPUTADO FEDERAL,PV,2,0,2,0.0,1.0
5238,2010,TO,DEPUTADO FEDERAL,DEM,3,1,4,0.25,0.75
5239,2010,TO,DEPUTADO FEDERAL,PTB,2,0,2,0.0,1.0
5240,2010,TO,DEPUTADO FEDERAL,PP,2,0,2,0.0,1.0
5241,2010,TO,DEPUTADO FEDERAL,PSDB,2,1,3,0.3333333333333333,0.6666666666666666
5242,2010,TO,DEPUTADO FEDERAL,PPS,3,0,3,0.0,1.0
5243,2010,TO,DEPUTADO FEDERAL,PT,3,1,4,0.25,0.75
5244,2010,TO,DEPUTADO FEDERAL,PTN,1,0,1,0.0,1.0
5245,2010,TO,DEPUTADO FEDERAL,PRTB,0,1,1,1.0,0.0
5246,2010,TO,DEPUTADO FEDERAL,PDT,1,0,1,0.0,1.0
5247,2010,TO,DEPUTADO FEDERAL,PRP,1,0,1,0.0,1.0
5248,2010,TO,DEPUTADO FEDERAL,PRB,1,0,1,0.0,1.0
5249,2010,TO,DEPUTADO FEDERAL,PSB,1,0,1,0.0,1.0
5250,2010,TO,DEPUTADO FEDERAL,PMDB,5,0,5,0.0,1.0
5251,2010,TO,DEPUTADO FEDERAL,PMN,2,1,3,0.3333333333333333,0.6666666666666666
5252,2010,TO,DEPUTADO FEDERAL,PSL,0,1,1,1.0,0.0
5253,2010,TO,DEPUTADO FEDERAL,PC do B,0,1,1,1.0,0.0
5254,2010,TO,DEPUTADO FEDERAL,PHS,1,0,1,0.0,1.0
5255,2010,TO,DEPUTADO FEDERAL,PSDC,0,1,1,1.0,0.0
5256,2010,TO,SENADOR,PR,2,0,2,0.0,1.0
5257,2010,TO,SENADOR,PMDB,1,0,1,0.0,1.0
5258,2010,TO,SENADOR,PT,1,0,1,0.0,1.0
5259,2014,TO,DEPUTADO ESTADUAL,PSB,16,9,25,0.36,0.64
5260,2014,TO,DEPUTADO ESTADUAL,PSC,2,1,3,0.3333333333333333,0.6666666666666666
5261,2014,TO,DEPUTADO ESTADUAL,PCB,1,1,2,0.5,0.5
5262,2014,TO,DEPUTADO ESTADUAL,PMDB,22,9,31,0.2903225806451613,0.7096774193548387
5263,2014,TO,DEPUTADO ESTADUAL,PSD,10,6,16,0.375,0.625
5264,2014,TO,DEPUTADO ESTADUAL,PSOL,17,9,26,0.34615384615384615,0.6538461538461539
5265,2014,TO,DEPUTADO ESTADUAL,PT,19,8,27,0.2962962962962963,0.7037037037037037
5266,2014,TO,DEPUTADO ESTADUAL,PSL,8,1,9,0.1111111111111111,0.8888888888888888
5267,2014,TO,DEPUTADO ESTADUAL,PTC,4,2,6,0.3333333333333333,0.6666666666666666
5268,2014,TO,DEPUTADO ESTADUAL,PR,8,3,11,0.2727272727272727,0.7272727272727273
5269,2014,TO,DEPUTADO ESTADUAL,PEN,1,0,1,0.0,1.0
5270,2014,TO,DEPUTADO ESTADUAL,DEM,2,1,3,0.3333333333333333,0.6666666666666666
5271,2014,TO,DEPUTADO ESTADUAL,PP,8,3,11,0.2727272727272727,0.7272727272727273
5272,2014,TO,DEPUTADO ESTADUAL,PRTB,3,1,4,0.25,0.75
5273,2014,TO,DEPUTADO ESTADUAL,SD,6,3,9,0.3333333333333333,0.6666666666666666
5274,2014,TO,DEPUTADO ESTADUAL,PV,10,5,15,0.3333333333333333,0.6666666666666666
5275,2014,TO,DEPUTADO ESTADUAL,PROS,7,4,11,0.36363636363636365,0.6363636363636364
5276,2014,TO,DEPUTADO ESTADUAL,PTN,4,2,6,0.3333333333333333,0.6666666666666666
5277,2014,TO,DEPUTADO ESTADUAL,PPL,6,2,8,0.25,0.75
5278,2014,TO,DEPUTADO ESTADUAL,PDT,5,4,9,0.4444444444444444,0.5555555555555556
5279,2014,TO,DEPUTADO ESTADUAL,PRB,2,1,3,0.3333333333333333,0.6666666666666666
5280,2014,TO,DEPUTADO ESTADUAL,PHS,5,0,5,0.0,1.0
5281,2014,TO,DEPUTADO ESTADUAL,PTB,5,1,6,0.16666666666666666,0.8333333333333334
5282,2014,TO,DEPUTADO ESTADUAL,PT do B,1,1,2,0.5,0.5
5283,2014,TO,DEPUTADO ESTADUAL,PPS,6,3,9,0.3333333333333333,0.6666666666666666
5284,2014,TO,DEPUTADO ESTADUAL,PSDB,4,2,6,0.3333333333333333,0.6666666666666666
5285,2014,TO,DEPUTADO ESTADUAL,PRP,4,1,5,0.2,0.8
5286,2014,TO,DEPUTADO ESTADUAL,PSDC,1,0,1,0.0,1.0
5287,2014,TO,DEPUTADO ESTADUAL,PC do B,5,2,7,0.2857142857142857,0.7142857142857143
5288,2014,TO,DEPUTADO ESTADUAL,PMN,4,1,5,0.2,0.8
5289,2014,TO,DEPUTADO FEDERAL,PSOL,5,2,7,0.2857142857142857,0.7142857142857143
5290,2014,TO,DEPUTADO FEDERAL,PR,3,1,4,0.25,0.75
5291,2014,TO,DEPUTADO FEDERAL,PV,2,1,3,0.3333333333333333,0.6666666666666666
5292,2014,TO,DEPUTADO FEDERAL,PPL,1,0,1,0.0,1.0
5293,2014,TO,DEPUTADO FEDERAL,PCB,1,0,1,0.0,1.0
5294,2014,TO,DEPUTADO FEDERAL,PPS,1,0,1,0.0,1.0
5295,2014,TO,DEPUTADO FEDERAL,PSDC,4,2,6,0.3333333333333333,0.6666666666666666
5296,2014,TO,DEPUTADO FEDERAL,SD,1,4,5,0.8,0.2
5297,2014,TO,DEPUTADO FEDERAL,PSB,2,1,3,0.3333333333333333,0.6666666666666666
5298,2014,TO,DEPUTADO FEDERAL,PHS,1,1,2,0.5,0.5
5299,2014,TO,DEPUTADO FEDERAL,PMDB,3,2,5,0.4,0.6
5300,2014,TO,DEPUTADO FEDERAL,PSC,1,0,1,0.0,1.0
5301,2014,TO,DEPUTADO FEDERAL,PMN,1,1,2,0.5,0.5
5302,2014,TO,DEPUTADO FEDERAL,PRTB,1,2,3,0.6666666666666666,0.3333333333333333
5303,2014,TO,DEPUTADO FEDERAL,PP,2,0,2,0.0,1.0
5304,2014,TO,DEPUTADO FEDERAL,PT,1,0,1,0.0,1.0
5305,2014,TO,DEPUTADO FEDERAL,PRP,2,0,2,0.0,1.0
5306,2014,TO,DEPUTADO FEDERAL,PSL,1,0,1,0.0,1.0
5307,2014,TO,DEPUTADO FEDERAL,DEM,1,1,2,0.5,0.5
5308,2014,TO,DEPUTADO FEDERAL,PTB,1,0,1,0.0,1.0
5309,2014,TO,DEPUTADO FEDERAL,PSD,1,0,1,0.0,1.0
5310,2014,TO,DEPUTADO FEDERAL,PRB,1,0,1,0.0,1.0
5311,2014,TO,DEPUTADO FEDERAL,PTN,1,0,1,0.0,1.0
5312,2014,TO,SENADOR,PMDB,0,1,1,1.0,0.0
5313,2014,TO,SENADOR,PCB,0,1,1,1.0,0.0
5314,2014,TO,SENADOR,PROS,1,0,1,0.0,1.0
5315,2014,TO,SENADOR,PSOL,1,0,1,0.0,1.0
5316,2014,TO,SENADOR,PRTB,1,0,1,0.0,1.0
5317,2014,TO,SENADOR,SD,1,0,1,0.0,1.0
5318,2018,TO,DEPUTADO ESTADUAL,PRB,2,1,3,0.3333333333333333,0.6666666666666666
5319,2018,TO,DEPUTADO ESTADUAL,DC,6,2,8,0.25,0.75
5320,2018,TO,DEPUTADO ESTADUAL,PMB,2,2,4,0.5,0.5
5321,2018,TO,DEPUTADO ESTADUAL,PR,5,3,8,0.375,0.625
5322,2018,TO,DEPUTADO ESTADUAL,AVANTE,4,2,6,0.3333333333333333,0.6666666666666666
5323,2018,TO,DEPUTADO ESTADUAL,PT,14,10,24,0.4166666666666667,0.5833333333333334
5324,2018,TO,DEPUTADO ESTADUAL,PSDB,5,3,8,0.375,0.625
5325,2018,TO,DEPUTADO ESTADUAL,PHS,8,5,13,0.38461538461538464,0.6153846153846154
5326,2018,TO,DEPUTADO ESTADUAL,PRP,6,0,6,0.0,1.0
5327,2018,TO,DEPUTADO ESTADUAL,MDB,8,4,12,0.3333333333333333,0.6666666666666666
5328,2018,TO,DEPUTADO ESTADUAL,PSB,8,3,11,0.2727272727272727,0.7272727272727273
5329,2018,TO,DEPUTADO ESTADUAL,PSL,5,3,8,0.375,0.625
5330,2018,TO,DEPUTADO ESTADUAL,PPL,3,0,3,0.0,1.0
5331,2018,TO,DEPUTADO ESTADUAL,PMN,8,4,12,0.3333333333333333,0.6666666666666666
5332,2018,TO,DEPUTADO ESTADUAL,PC do B,4,0,4,0.0,1.0
5333,2018,TO,DEPUTADO ESTADUAL,PTC,2,0,2,0.0,1.0
5334,2018,TO,DEPUTADO ESTADUAL,PRTB,18,10,28,0.35714285714285715,0.6428571428571429
5335,2018,TO,DEPUTADO ESTADUAL,PP,1,1,2,0.5,0.5
5336,2018,TO,DEPUTADO ESTADUAL,PROS,5,0,5,0.0,1.0
5337,2018,TO,DEPUTADO ESTADUAL,REDE,5,3,8,0.375,0.625
5338,2018,TO,DEPUTADO ESTADUAL,DEM,3,4,7,0.5714285714285714,0.42857142857142855
5339,2018,TO,DEPUTADO ESTADUAL,SOLIDARIEDADE,4,0,4,0.0,1.0
5340,2018,TO,DEPUTADO ESTADUAL,PPS,9,6,15,0.4,0.6
5341,2018,TO,DEPUTADO ESTADUAL,PSC,1,1,2,0.5,0.5
5342,2018,TO,DEPUTADO ESTADUAL,PATRI,3,1,4,0.25,0.75
5343,2018,TO,DEPUTADO ESTADUAL,PTB,0,2,2,1.0,0.0
5344,2018,TO,DEPUTADO ESTADUAL,PSD,1,0,1,0.0,1.0
5345,2018,TO,DEPUTADO ESTADUAL,PV,6,1,7,0.14285714285714285,0.8571428571428571
5346,2018,TO,DEPUTADO ESTADUAL,PODE,3,2,5,0.4,0.6
5347,2018,TO,DEPUTADO ESTADUAL,PDT,5,1,6,0.16666666666666666,0.8333333333333334
5348,2018,TO,DEPUTADO ESTADUAL,PSOL,2,1,3,0.3333333333333333,0.6666666666666666
5349,2018,TO,DEPUTADO FEDERAL,PATRI,1,1,2,0.5,0.5
5350,2018,TO,DEPUTADO FEDERAL,PSOL,2,2,4,0.5,0.5
5351,2018,TO,DEPUTADO FEDERAL,PRTB,7,5,12,0.4166666666666667,0.5833333333333334
5352,2018,TO,DEPUTADO FEDERAL,DC,2,1,3,0.3333333333333333,0.6666666666666666
5353,2018,TO,DEPUTADO FEDERAL,PHS,1,2,3,0.6666666666666666,0.3333333333333333
5354,2018,TO,DEPUTADO FEDERAL,DEM,1,1,2,0.5,0.5
5355,2018,TO,DEPUTADO FEDERAL,PT,7,2,9,0.2222222222222222,0.7777777777777778
5356,2018,TO,DEPUTADO FEDERAL,PR,1,1,2,0.5,0.5
5357,2018,TO,DEPUTADO FEDERAL,PRP,2,0,2,0.0,1.0
5358,2018,TO,DEPUTADO FEDERAL,SOLIDARIEDADE,2,0,2,0.0,1.0
5359,2018,TO,DEPUTADO FEDERAL,PPS,1,0,1,0.0,1.0
5360,2018,TO,DEPUTADO FEDERAL,PMB,2,0,2,0.0,1.0
5361,2018,TO,DEPUTADO FEDERAL,PSL,6,4,10,0.4,0.6
5362,2018,TO,DEPUTADO FEDERAL,PPL,1,1,2,0.5,0.5
5363,2018,TO,DEPUTADO FEDERAL,PSB,2,1,3,0.3333333333333333,0.6666666666666666
5364,2018,TO,DEPUTADO FEDERAL,PRB,1,1,2,0.5,0.5
5365,2018,TO,DEPUTADO FEDERAL,PSDB,5,1,6,0.16666666666666666,0.8333333333333334
5366,2018,TO,DEPUTADO FEDERAL,PSD,1,1,2,0.5,0.5
5367,2018,TO,DEPUTADO FEDERAL,AVANTE,1,0,1,0.0,1.0
5368,2018,TO,DEPUTADO FEDERAL,PDT,1,0,1,0.0,1.0
5369,2018,TO,DEPUTADO FEDERAL,MDB,0,1,1,1.0,0.0
5370,2018,TO,DEPUTADO FEDERAL,PTC,1,0,1,0.0,1.0
5371,2018,TO,DEPUTADO FEDERAL,PC do B,1,1,2,0.5,0.5
5372,2018,TO,DEPUTADO FEDERAL,PV,2,0,2,0.0,1.0
5373,2018,TO,DEPUTADO FEDERAL,REDE,1,1,2,0.5,0.5
5374,2018,TO,DEPUTADO FEDERAL,PROS,0,1,1,1.0,0.0
5375,2018,TO,DEPUTADO FEDERAL,PODE,1,1,2,0.5,0.5
5376,2018,TO,DEPUTADO FEDERAL,PSC,1,0,1,0.0,1.0
5377,2018,TO,DEPUTADO FEDERAL,PMN,1,1,2,0.5,0.5
5378,2018,TO,DEPUTADO FEDERAL,PP,1,0,1,0.0,1.0
